M-------BB---B-EM-MBB-B-M------BB-Mo?--?-?ME-oo-?M-B-o?M-B?E?-MBEM--?EB?o?B-?B-M----o-BM?-?M-?-B---B--E--?M-MM?MBoB-??--o-?M--?BM---B-???-BEo---?EMBB-----oBBBM---E--?-?----oo?---BM-EMMB--Mo-oE-M--oBE?
B-M?-?---o-??--Mo?EE-o-M----B---o-MBoo--o-M?E-MBoooMM?o-?B-MB--?-?o-B-o-oM-?EBB-M--MM--B-MMM---B-B-?E?---MMooMM-oB-MM-M----B?EM-M-o-oo---o--E---MBo-M--M-BBMB-B-B--Mo-B-M-BBo-BB?oo-?-M-?---?o?-?-?---M-
oB--o---------o---?M--B?M?E---?M-o----?o-M?MBB-?-----??--?--o-M--o----B-M---B--EMB-BEB-?oo-M--B-???o---MoM-M-B-BoM--Eo-o-Bo-E?o-ME-E-?oEB-o--B---BM-?M-o-----o-o---MM-M-E-BB-------?--M-EBMoB--?---BM-BE
--?--B?oB?-oo----?M-??---oB-E?BE?----BB-?-M-?o?-EBBo-M---B?EEM--MB--MBM-E----MMB-ooE---B--oB-M----------M-E--E-B?--E--oM-oo??-BM--MB?Bo-M-o--M??B-EB-M--EB-?oE-MB--?--B-?--B-oBM-oE?B---?--o----oM??--?-
o?-EBM-MB?---EM--o--BM?---o-B---B-o-E--EMBo--E-E?MMo-B----o?BM?-oB--?BBE----MBB??oo-----Eo-o-B--M-M--oM--MM-M?oB---M---ooM-?MMoB----Eoo-Mooo--o--??M?--?--M--B?--M--oMB-oo---B?E--B-oEBo-E?--M--Bo---o??
Bo-----BB?-MMM-B----o-----BBEB--MB----oMBo--EB-??-------?M-B-oM?M---o-o-o-oM-Mo-o-ME-?--?--o-M-BMMo--M---MB?--E-M-?--Eo-?EBMBMM--E?-B-?-?-o?-BooM-o?---?ME-o-EoEoo-?MB-B--BME-?-oM--?----Mo------BEMEMoo
E----oMBBE--------EMME-?BBoBBo-o-E-?------B--?B-B--BB-BooB--B--o-?----?E-o?MEo-B--E?E-MEoB-B-EMM-------o?----M--Mo--E?---MM-B-?o---oo--??BME----------o--?B?-?-B-----B-oo-?o--?B?oMo--?-E?--E-?-?-MBMEE-
?o---M-?BMo-o----EBE??E--M--o--o--?-EMoo---------M---M?-E-oo?-oMoB-----MoE-B-----MM-Bo--E-EB-??-----oE-??-M----B-MB-M---o-?E-?BME-E----------M?--EE?--o?E-oM-M--EM-ooM-oE-?-o-----?--?MoMMBo?BB---B?-??v
o--E---E-E----EM-?-?-oM-o--oB-B?o---?o-------------B-?--M-oMBBBo--B----MMB?----o?Bo-B---BM--o-B-----BM--M--o--?B-MB--?-B--?-B----?M-M-Bo--oM-?B---B-M?--BMB???ooB-E-o?-?---o--o--E--EBo?-M?----?o-o--BM-
----oBB-oMB--??M-------??---BM-M-EB-?--?oo-----?--E-?-B---?-?MBM-M--E--EM?E--?ooM-oo-Bo-EBM-BB---E?E-?--Eoo-EoM---?--E--o-?o-----?Mo?-------BE?oEEB--M--?B--B?B??B?-?EMM?--M-MEoB?-?--M-M-E?E---o-ooEE--
--?--o--B--?-----oEo-?M--?--o?M??MMM-?-B?--MB--?E-B--?-EM-Mo--oBoo?E-M?-o?-o-o--?-o---o?M-----M--?BBE-o?M---?M-oBBo--M?M---M--o--ME?--?M-BM--MM?-?M-----o--?----oME-o--?BMo--B??-EEoMB?MBM-?M?-B-?E-M?oB
--E-EM---M--M?ME-M?-----?----?-Bo-Mo-?-BM--o-?B-?-----B?M--M--?--M-B?MBBMBoME---M---oMoB-E-B--E?--ME--?--o-BEM---?----EEM---?--E-?--o--ME-o-B---?E---M-B-ME-----o---o-M-BoM--o-MEM?-B-?--?MB-?-o--M-E-M-
B-B-BoMBMo-o--E--?--o?-o---B--o-E-??B-MMEo----BB-----EE-----E?--EM-?-E--M----BE-?Mo-?E?EEMBBM-MEME-----o--B?M---M?MM-BMMBBB--?-M?---E---B-?--?--BM-M-oM---BEBBE?B-M--------M?---BMB---M-M-oB--------MoM?
-M---E--EoTo-B?--M-E?-B?-MMoEMo----TTo-E-MMMEETM-?T-o--BMM--MMM-?-oB---?-o---MT-T-BB-BoT?TT-EToM-?T?--o-o-?--o-BE--TMET-TMB-MM??-o-T?oM-B--oo-M?-ooM-T-?Mo-M--MMMM?-E?--o-BM?-o?-?BoM--BB-T--B-T?---E-B?
m----Bo-BM|o-M-M--MB-E--?E-MM-B----||o-???BB-M|-M?|---EMoE-o?-oEB-B-?--M---oB-|-|o-B?--|B||-B|?MBM|-MEEE-E-BoEEM-M-|M-|E|-E--MM-B-o|??M?o--EBEB-?o??-|E-E??---M----oM-BBEEoMBE-ME-EoEBEo--|E-Eo|-EM?-BoB
XXXXXXXXXXXXXXXXXXXXXXXXXXXXXXXXXXXXXXXXXXXXXXXXXXXXXXXXXXXXXXXXXXXXXXXXXXXXXXXXXXXXXXXXXXXXXXXXXXXXXXXXXXXXXXXXXXXXXXXXXXXXXXXXXXXXXXXXXXXXXXXXXXXXXXXXXXXXXXXXXXXXXXXXXXXXXXXXXXXXXXXXXXXXXXXXXXXXXXXX
