--B--oooM?--BBoM-oo--o--B----M?M-?ME?o-ME?oB??EB-B-E??MMM-B-----Bo-M-o--M--B?oM-E?M?--oEM---B?-MEE--???oM?BM--o----B?-?-?--BoEoo-ooE-E---?-?-Mooo-B?B??B-------?-o--?o--Eooo--?oE-o?BoM------o--o-E??-oo
o-?--M--Mo-B--B?--BBo?-?E-o---oEo-?M-EB-Mo?E--B?---M--?M---E-oM-o-BEB?-?BB-B-Eo?-?B----M-o--oBB?--o--o-o?B--o?EM----?--?-?-?-?E-o-?-??BB?-oo-B---?o--E?BM?E-ME-B--o?o-B--?-M-???-o-B--oBoE-MEo-o-B-o?-oo
B-?M-?o--B?----E-B?-EBE---EM--B--o?--M---?-?-Mo-----EB--B-?B-o?-M---?--?o--o-M--oBB-?ooBE--o-o-E-BBBoE-E--M--o--???---oMM---oBM-?BoMMMo-?E-BoB-M??-Bo-Mo-B--BM-o-o?--oBB-M--o-B--oo--?M?----MMEBM--?--oo
--??--M-oM?Bo?B-EE?BB---E?--EB-E?o---oE-MEo-?-E---MM??-?-o-M-ooME-BoM----?E-EM---?-B-?--Mooo------o??-B--ME??M?-MB----??-??oo?ooEB--ooo-o--?B-B--o-oMMoB-Eo--oo?M---oB-BB-oo--o?-?BBEB-oMEM--o-o----o-oo
??ooBBM--o--o-?-M-?E---?BMo??--??oM-?MBo-?M-oB-BMBB--B--??--EMB?M--??oE?-oM--Bo-M??Bo-o-M-E?-o-BBBM-E-oM---?-M-?ME-Mo-M---MB?M-EB-oM?oM----BM---ooMEMo-o-B-?E-o--EBEB---B--E---ooooo--?-M?-B-?--?o-oo-oo
--?oM----Mo---?---??oBo-oBoB-M-B-o--oo--B----BBMo-E-???EM-o-M-oE?--BEM?ooMBBB?-o???M-o-?M-??-Bo-?M---------BM-?--BoMMEB--B--oB-B?B-oBoMo----oM-??oM--ME?-B?BB???B--B--?o-oM-B---M-?M-E?oo-M-?---EE--?-oo
--MB-o??B-Mo?-MBMBo-?-o-o-ooMo--MooMME-M?o--M--?oo?-?o--?-?o-M-?ooBMB-oo-?ooMo---?-oMM?B-?---?-MBM-oM--o-?---o--B-M?-ooE--o---B?--?M----E-?-oo---MB--MMo--o-?-M?E?oo-?B---Mo-------MM--M-BM?-M?--B-MM-oo
-?--??BM-B--Bo---??--M??---B-BM---oo-M---E-?E-M--?o-?---B-BM?-?---Bo--B?--?--BMB?o--B?oB-E??oo-B-ooM?-EoMo?B--o-?M?-?o--??oooB--M---BM-??MM----Eo?o-B-MMoE--M--o----o-BB?B?E-?-o-o-E-----M--B?o--o-B-voo
o-Mo--E--MMEo-oB?-o?-?---oEB?-o-?--ooE--?B-BM?-M----?B-BB?M?ooB-?--o-Mo?BB---BoooMo?-BB?--EM?-o-E-o-M??B--Eo?--?o-??-oM-??--BBBE----??Bo-?ooB-MB--ooo?--MM??-?----o-?---EM-?--o--BM?-MoB-??o-?---E-BBfoo
?--M-M?ooB-Mo--?Bo-B--B?o--MBo--E-MB---?-B?Bo?-B-??M-oM-B-?EMEEo-M?E-oMoM-E-EBM--?oM----Bo??oBBM---o--oM--B?o-oMB-M-M----?--ME-?oMBM-?E?BB---MM-o?Mo-B?-BM-B--M-Bo?o----M?---o??M?o-EBBB-MB-Eo-B-M-Mofoo
-E---o-M-?B--M-Bo?o?BM--o-M-M?M-?oM?--oo-?o?B----oM--oo-BoBMMM?--?--?-o?o?M-BooM?-o-E-BE?-Moo?-o-o?-Bo-?o-E?--o-E?Booo-B?E---M-B?oEooB--B---o?-?-------oM?---oM??B-EE-BM-M?--Bo-o-o--M---B--??-M?-M-Efoo
o??E--oM--?-M------BoM---M?-?B-oBoBo-oEBo?oBBBE-oM?M-o??BB-E-B--B-M-E-?-E?BB-M--oM?--o--M--oE--o??--BooMo-M-E?---B-?-?-Mo-oB----?-?--E?BE-B---??MM--BMoM-oBo-B-MMMoM?--M-o??--M-?M?E?oEoo?M--MooE-MEBfoo
oMo--M-MMEo-?-E----?Moo--BoME-o-o--?-----Bo-M-Bo-o-o?-E-?Eo---Mo-oM?-?MoMoo-?o-----B---oo?Eoo?oM-B---B--M---o-B-B?MBo-o--?MM--o?----?M?---BoB---E-oMBMBBBM??--o-MB-o??M-oM-E--B----M-MBM?-o---M???o--foo
M--o-?o--M--?M-oo--M-?o--?----?--?-?--B?-B-?B---o-?-ME??--oE--o-oE?o?-Eo-oM-E-?B-BB----?-E-M---o-E--B--EB--oM--MB?M??o-------o-----B-?oB?-?-E?-oM?Bo--E--B--B-?-?--E-?-oo?B-BE??--?o?oo-?--E--?--M-M-foo
m----------------------------------------------------------------------------------------------------------------------------------------------------------------------------------------------------foo
X----------------------------------------------------------------------------------------------------------------------------------------------------------------------------------------------------fXX
