--------------------------------------------------------------------------------------------------------------------------------------------------------------------------------------X-----------------
----------------------------o---------------------------------------------------------------------------------------------------------------------------------------------------------------------------
--------------------------------XXX---------------------------------------------------------------------------------------------------------------------------------------------------------------------
--------------------------------X-----------------------------------------------------------------------------------------------------------------------------------------------------------------------
-----------------------?---------------------------------T----------------------------------------------------------------------------------------------------------------------------------------------
-----o---------------------------------------------------|----------------------------------------------------------------------------------------------------------------------------------------------
---------------M-----------------------------------------|--------------------X-------------------------------------------------------------------------------------------------------------------------
----------------o---------T---------------------------?--|-------------------XX------------------------------------------------------------------------------------------------------------------------v
--T------?????------------|------------------------------|------------------XXX------------------------------------------------------------------------------------------------------------------------f
--|-----------------------|------------------------------|-----------------XXXX----------------------------------------------------------------------------------------------T------------------BBBBBBBf
--|-------------X---T-----|------------------------------|----------------XXXXX----------------------------------------------------------------------------------------------|-------------------------f
--|------------XX---|-----|-----------------------?------|-??------------XXXXXX----------------------------------------------------------------------------------------------|-------------------------f
--|-----------XXX---|o----|-----?------------------------|--------------XXXXXXX----------------------------------------------------------------------------------------------|-------------------------f
--|--T-------XXXX---|-----|------------------------------|-------------XXXXXXXX----------------------------------------------------------------------------------------------|-------------------------f
mE|--|---E--XXXXX--E|----X|-E-----E---------E------------|-----E------XXXXXXXXX----------------------------------------------------------------------------------------------|-------------------------X
XX|--|-----XXXXXXXXX|XXXXX|XXXXXXXXXXXXXXXXX------XX?XXXX|XXXXXXXXXXXXXXXXXXXXXXXXXXXXXXXXXXXXXXXXXXXXXXXXXXXXXXXXXXXXXXXXXXXXXXXXXXXXXXXXXXXXXXXXXXXXXXXXXXXXXXXXXXXXXXXXXXX|XXXXXXXXXXXXXXXXXXXXXXXXXX
