----M-oM-o??-oBMo-?M?E?Mo----?B-B-?o-E--M?--BBM-o--M---o-M--E-E?-B---M-?oo---M----oEEoB-?--B-oBMB--?-M---o?-B?--o?MEo--B-BM------o-oB?----?-BM--?M?-o?E-E--?---M-BB---B?M-E-o?oBME?o--o---?EM--B-M--oo?-
-o?M-B?------?--EBM-M-?Eoo-o--BME----B----Mo-B-M?---ooE-?------o--E----M-?--M-----M-B?-M---oB---??M-Mo?---E-?Eo----B-BMoB-B?EEo--Bo-o---oM------oB---E?MBMM-?--Bo-----MM-EB?--ME-B-MEB?--B----o-M?-?----
?o--B-E----M-----B-?BM-MB?MMM?--MBo?o-oEoo-?-ooBo-?---B?ME-o-M---M---??---M-o-?M---?BEBM--Mo---oE-o----o-oM--Boo?-o-??E---?EB-BM?B--MB-MMEoo--M-o?E-?---MB--M-?o--?-o?M--B?---------BM?--EM-B?--?o--EB-?
------??B-o?oB---BoE--EMM---?MM--B---E-B?MB---?--Mo--MEB--E-M--?-B-M-?B--oE---o-o?--B?----EM-E--?MBo--B--BB--M-M--------BM-M-B?--B-B-oE?-M?----E?-ME?---M-oM-?-E?o-Bo???BM-B-o-M--?--B-M?B----------BoEB
--BoBMBMM----?ooMM?M?M-o---o--Boo-Eo-BE?o-o-o-M-o--oo-M---BM--?---?-oo--Eo-MMoE?MEB-B-o-o-?o---?-??--?-?-----B?--B-?-EooE-?o-M--?o----Bo?-?o--?-o--M----M-BM???M?o--M-?--?-M-M-??M-?oB--o--ooo--M---oMB-
-?-B-----B-M-M-?M-oM???---?-BB?-BB?-E-BE-BE--M-BB-?-M-M??-oMM----o-EM?E?-B-?B-BEM?o--B?MM-?oEB-B?---E--M---EMBB------M-----Moo--?oE-?-------?EEM-oB-B-??M?o-oo-B-M?---E-E-Mo?-E-------MEoM?-BMB?-B--Mo--
o---M?-E-?o-oo---ooB-MEoMM?oMMMo?-?M-?-BoB--?-BBo--EB---B----o----o--o?---o-M-M-?--------E--M---?---?M--oBBB-o-Mo-E-B--oB??---?Boo----Eo-B-BoM--M?--MMMB?o----M-M---B-B-MBB-MM?-M-E-M-M--?M-?B--M?---EBo
BoM--BE---M-M?BEB--oo-M--MMB-MM-EooB-EEB-oEM---BM--?M--M--------M?E--?M--o?BMo-o-E-B--oo-----?M-MB?B?-?--MM------B?-o-o?------M?-M-oE-MoBEE--EB?oE-o?M------M?B--M---MMB-MBB--B-E--o--?M-------M-M-B-MBv
-B-B--M-Mo--o-M--?-BE?BB---o--M?---MBB--M--o?-B-M-oB?---M--?---ooB-----?-o?-MBoB-BE-------oMB-EB?-B-M?-oB----B------?-MM---M-M----M--oo??-BM-Mo-M--B--B??--MMB-oE-o---Mo-MMB---BMB?MM---EMEM--oB-oE-o--B
-M-E-E-oMMMo-oB--Mo?-BE-ooBM?-o--o--ooB------oM-----oBM-EMB---B----------o-?ME--M--?--EEM------M-?-o-MM-o-o-oB?M--MoEo-Moo-?-M--?--oBoM---B--?-oBM??B-?--o-BB-?--?-?-BEo--MM--?-Bo--B-o-----o-oo--B---M?
-oo--Mo-??--o-oM---BB-M----M?-M?Eo?oM-B-E--?o?--Eo---B--M----oBB-o----o--Bo-o--Eoo?-MEBBo--?-E---M--?--oo-EoM-----?--B--?M--E--M----o-oM---oB---B-o?Bo-M--Mo-E--B-oM??BM-----M--?-oBMMB--M?----M--?o--M-
--B--o?----Eo-oo-----o-E--?-EB---Boo-MMM---?---?-oo--?-----oB-B-o-o--EB-EBM-o-M?oM-o---?E-M???M--oM-?M?---M---B--E--------B---?M-?---B---E--M--oEMEE-E--M--?E-?E--o----BEM-BBBooE??-oE-?-?ME-oo--BM-B--?
B-oB-E?-B-oMBoE-M-?MM-M-o-BM?o-BEo-o----------BM?Bo--Bo---E?---M--oB--?B?--?M-EBBEBo---M-?-E---ME-M-E--oo-To?-B-?ToB-BoEM-M??-M--M--MB-o---MT----o-B---?----M----MM-M-?--?--E---??o-B--MMM-------oEMo---
B-?TBM----M-M-----T-----BoE???ooBoBTTTBMo--TMTE--EMoE-B--TT-B--?B--BoE-oTBTTTo?--M?oBMT?-T?-oEoB-MMoTB-T-T|?B--E-|B-?-E-MoB-E--B-MEM--o-TM?-|-EB-?-T?-o-----TMB-----Bo-BBMo--E---o??ToM-?-T--?-TEB--B--o
mE-|M-o---B--BM?EB|EEM--?B--EE?-M--|||E-BE-|o|-B-?oE-M?Mo||-?--E?-EB-M--|E|||?BM-o?EEM|-E|M?-M-M?oo?|?M|?||o-ME?-|--M---Mo-oM?M?-oM?MBB-|-?o|EBEM--|-E-oo-?-|---B-M--oE-oMooE-?-E-oB|ooBBB|--EM|??oE-BM?
XXXXXXXXXXXXXXXXXXXXXXXXXXXXXXXXXXXXXXXXXXXXXXXXXXXXXXXXXXXXXXXXXXXXXXXXXXXXXXXXXXXXXXXXXXXXXXXXXXXXXXXXXXXXXXXXXXXXXXXXXXXXXXXXXXXXXXXXXXXXXXXXXXXXXXXXXXXXXXXXXXXXXXXXXXXXXXXXXXXXXXXXXXXXXXXXXXXXXXXX
