-----BEBM-B??oo-o--E---M--BooMB---M--------E--?-?M?-Mo--BB--o-----E?M-M?---?B-Eo-M--BM?M---M-EM-?--o-o--BMM--EB--B-?E?--?-o--?o--B--?Eo?--BMM-?B-BM-M---M--EB-MBM??-o-o--B?-B--E----E-M-Moo--E-E---E--oo
-??-?-M-o----?--BME-?oBME--EMo?M-o-o-EMBoB-----oMo?--oB---M?------M-BoE----M?-?Bo----o-M---oM?--BBoooMM-?-oME---M-BM-----o-----E-E------B--?oM--M--E--Bo??-M?----??---oooB-EMBMBo---?MB-E-EM--MMB-oB--oo
M-M--M-Eoo----BBM--??M-E---BEo--E--o--BMB--M--oB-o-o-M-E?M----o?BE?--??B-BEE-----?B?B?M---?M---oE--MBo-?-?-M-Eo-o---MM---E-B?-----?E---BM--M--oo-o-MBEoo--EoB?-E-oE?o-E-----?--oo--o--o-Mo-?-MB-BM--E-oo
--?------M--BoB-o----MoM--------?-B------B??-M?-----o-o--o?--M---?-----M?BM---M---oo-----?B?-Mo?B-?---oM--o--MM----oB?M?-----oo---o--?E--oM-E?-E-E-Bo---BMME--EM?--??-M-M-B?BB?E--B-o--MoB-M-B--E--?--oo
----M-M?-B-BoEEE-M---B-?-o?oE-o?-?-ME-----?-oM---M-?E-B-o?-B---E---E-EMooo?EE-?o--Moo--B-MB----B--M-?-?-M?B-M?-EBB?o-ME-E------BB-E?M-?-E--o--B?o?M---o-?-E?-oM-?M?M--MB--?E--M-o-?----EM-E-E-o-B-----oo
-EM-E-o----BB-?----M-MooB--EM-BM-?-B-?-Eo-?E?---B?o?-BM-o--o--MM---B--oo----------?M-B-BM?M?---------MMoo-B-MB-?M--E-?B----?o----EM----?MM-B?-?----E?----B?-o--B----E?--E-o-o--BE-Eo--B?B-B------B----oo
--o?M--M-M?E------oMo----M--BB-?---o-o-BBBo?---M-o---?----?o-?o-----B?---o-E-BMoo?-?BB-M--M-?B-?-EEM??-MME-----oo-o-M-?o-?-B-BM?--E-Bo-o?MB-?-?oBo?--B-M-?E----M-E--?--M---?Eo---?B-Bo-----oME---ooB--oo
M?-M--oBE-E--oB-EM-M-o-o?---M?oMo--o---E-M--M--B-?-?-?----M-M-oB--oo--E--M--o-MM---o-E-EME-M----oMB-B?--oB--?--o-BM-----Eo-?o-o--M-E--B-?--M?M------M?-?--?o--oo?Mo-oEo---?-?o-o-----M----o??--M--M??voo
o-M-E-B--o-B?-E-?B-B---MM--B-B---?o-EMo--o?EM--?M-M-M--oo-Bo-MooB?-B-?------M--E--o-?BE?EB-o--?--MM--M--o-?-E-BEoo-M--Eo--??BM-M--E-?-MEB?o?M-----?MM--B--M?--B-MB---MBB-EB---o--B?-B----?-o---BMM-M-foo
o-E-B------?--M-B--E?M-M--?BB--??---MM--M-??-BE--oMM--?B-MM?-?MoM-BE--o-E-oBB?B-EB--E?B-MM??o-?o-B-BMMo-BB--?-M-?-M-----BMM---o?oM-Eo--B-o-o--MoBB----?B--?-M?M---?-o-----?-M-E---??Moo---MoE--??-E-Efoo
?o?---B---oMo--BB??M-E--B--?-?E-BM---B-M---oM--B-E?M-?B-B?BE-o--B?--?-----??B?--MB-M?-E-EoBMM-----o-o?EMo---B-MB-MEMEB?M-E-?--E?-oB--M---?o---B------o--M-o-B--oB-M?-ooo-M-o?MB-M--M--o-o---M---BoM--foo
-EBM--B--E?-M--MB-B-B---oB-o--B---MoMEM-EM?-?-oME?---MM?---BE-?---Mo-o-MMB-BEB-o-E-?oBM-BB--?o------Eo??-o?BE--?Bo--B---BMMoMM--M-BB---ooo-B-E-oo---o-?Eo-?---Mo-?oM--M----?o-?E-Bo-oMo---M----?EoBE?foo
--?-oo-M-?E-?-?-M--B-o-M?Moo-E-ooo--M-oM---Bo-M-B----B-Mo----BMBBoB?M-M-E----o-?BB-E------o--?---BoEME-?o-B-BoM-?o-o-ME-BB??-M-??oT-B--M?ME--B--o-E?-oMB-?--E?o--o--?o-o-ME-?o-?M-M-M?--?MoM---oM?--Bfoo
--TBoE?E-B--oM-oEoBBMMEM--MT?B?-o-BoT--T---o---T---B-TEB--B-BMTBMTB-o?TMMB--BE---EEM--BoE-o-?-M--Eo-TM----BB---BoT-o-----TTM--MB--|--?-MBT----BB-TM-B-?TBT--MTTT-MMM-B-?-oT-MoE--B-B--B??MB-M--T--MM-foo
mo|BBMo?BM--?-M?Moo?M---M-B|B?-E-EB-|?-|o?E-Mo-|-o?-o|-Mo----B|MM|----|-BB--o??--M?B?-BE----EoE-E-B-|BM-?-M-BMM-M|oE-oo-M||oEE-o?-|?E--oo|?oME--M|B--oB|-|ME?|||B--o-E-M--|-o??-BE--EEE??E?-E-?|oBoMEfoo
XXXXXXXXXXXXXXXXXXXXXXXXXXXXXXXXXXXXXXXXXXXXXXXXXXXXXXXXXXXXXXXXXXXXXXXXXXXXXXXXXXXXXXXXXXXXXXXXXXXXXXXXXXXXXXXXXXXXXXXXXXXXXXXXXXXXXXXXXXXXXXXXXXXXXXXXXXXXXXXXXXXXXXXXXXXXXXXXXXXXXXXXXXXXXXXXXXXXXfXX
