---------------------o-----------------------------------------------------------------------------XXX?---------------------------------------------------M---------------------------------------------
-----------------------------------------------------------------------------------------?------------M----------------------------------------------------------------------------------???------------
-----------o-------------------------------------------------------------------------------------X------------------------------------------------------------------------------------------------------
----------------o-?------T---------------------------------------------------------M----------------T-------------------------------------------------------------------------------?-------------------
-----------------T---T---|------------------------------------------------------X-------------------|---------------------------------------------------------------------------------------------------
-----X-----------|---|---|----------------------------------------------------------------T---------|----------------------------------------------------------------X----------------------------------
-----------------|---|---|------X-------------------------------------o--------------o----|o-------T|BBBBB-----------------------------------------------------------XXXXXXXX---------------X-----------
---------T-------|---|---|---X-XX-------------------------------------------------?------T|----M---||-T--------------------------------------------------------------XXX---------------T----XX-M-------v
---------|-T-----|T--|---|---XXXX-------------------------------------------------?XXXXX-||-X----M-||-|----T---------------------------------------------------------XXXX--------------|----XXX--------f
---------|-|-----||--|---|---XXXX--------------------------------------------------------||XXT-----||-|----|-----------------------------M---------------------------XXXXX-------------|----XXXX-------f
---------|-|-----||--|---|--XXXXX------------------------------------------------------o-||XX|X----||-|----|-------------------------------------------------------??XXXXXX------------|----XXXXX------f
---------|-|-----||--|---|-XXXXXXX-------------------------------------------------------||XX|XX---||X|----|------------o--------------------------------------------XXXXXXX-----------|----XXXXXX--M--f
------M--|-|--?--||--|---|XXXXXXXXX------------------------------------------------o-----||XX|XXX--||X|----|---------------------T-----------------------------------XXXXXXXX----------|----XXXXXXX----f
---------|-|--X--||--|-B-|XXXXXXXXXX-----------------------------------------------------||XX|XXXX-||X|X---|---------------------|-------------------------------?---XXXXXXXXX-----X---|----XXXXXXXX---f
m--E--E--|-|-XX--||--|--X|XXXXXXXXXXX----------------------------------------E-------E---||XX|XXXXX||X|XX--|---------------------|-----------------------------------XXXXXXXXXX--EBXX??|----XXXXXXXXX--X
XXXXXXXXX|-|XXX--||--|-XX|XXXXXXXXXXXXXXXXXXXXXXXXXXXXXXXXXXXXXXXXXXXXXX----XXXXXXXXXXXX-||XX|XXXXX||X|XXXB|--X-------XXXXXXXXXXX|XXXXXXXXXXXXXXXXXXXXXXXXXXXXXXXXXXXXXXXXXXXXXXX--XXXX|XXXXXXXXXXXXXXXX
