M-o?-B-B--?o?Mo---E-E?--Eo?E--??Eo-E-M-o---MM-----EM---?M--MBB-B-Mo--M---E?--B---M-M?-BooB--BoEB-M----?----B---?B--??----M--?-o--BBo-BM-o-?B--BMo-M----MME-o?MB--?-B--M-?BMB?M?B---?o--BB-EM-----MM---oo
o-Boo-----BBB-?-?oM-M--MMoB?--BEM--ME--??E-o-------o--Eo----o--E-E-EoBM-o-B?-?-o--M-B--M-?BMo-B?M------ME-??-M-B-EE-?----------B-?B?E-??----E?-EMB-E--B-BB-M-ooEB-oB--B?-oo--MMo-B-o-?-M---Bo--oM-M-?-oo
M-BoBooM-??BooooM--Bo-E--E-----B?E--BE--oM--M?----Bo-??Mo?-??--?MBM--BE-----M-EM?-------BB------E--?-Boo-Bo--?o-M?----ooo?o--EM---?--?-B-oB-MM-----?---?-BE--M--B-----EB-?---E-B--?-------M??----Mooo-oo
--E??B?B---oE-??--B--?--M--BEBoM?Bo?o?M-----o-o---?--oM---?-o?M-B-E--o-------B?o-BB---M-M?--B-?oM---B---?-oEo---Boo-o-oEo--BB?MB-M??oB--?-B?-?---MMBM---E-M---??------M?--?E--E?o-----M--?---?-??BB---oo
EMM?--MM-?-?-----?B?oE--EE----EBBM-?o-----E-BEM----M-oM-o-?-o---?M-oo-Mo----Eo-Mo-M-oB---MM-o-?-o------BM??--ooEME-B?o-M-??o---?-?o--?-oEooEoBM?M?E?EM----B-o-EMM-B-MB?-M-EMoE-M----?Mo--MEMo-Bo--B---oo
-MBBB------?--oM-o--oB-B--M-oMB-o?-M--MMB----?--oE---B-M-?-B-B----E-MEoB--BBB-B-?--?--B------B-oM--MBo------B-oBM??Mo?----o-o-M------o---?B-M-BM--?-M--Bo---MBM-BEo-M-M-Bo?-B--BB-oBB----BM?Bo-MEo-oE-oo
o------??---EEB-?--?E-B?--oBM--BBEM-EEM?--M-E---o--E-M?-??oB--BM?M-------?-?---EM-?M-o----?---B----?-Eo-M-MB?-o-B-?----?BM--o--MB-M-?o-EB-MB-?-M--oBMMM?--B---?-B?M-B----?--o-o---MMEoMM-oooB?--B--?--oo
--MB-----M-M--?---BoBMB-MEB?--BM--o-M?-o?o--M--------E--oo?--oM--?M--Bo-?--MoB--?---B--E-?Bo-o-MEEo-----oB-o?---?E----o---M--oo-BM--E--B?--?--EM-o--oo?----o?MBo-o?--MoME-EM-o-B---o-??-M----M-??EM--voo
--M-----EEM--EoEB--?B?MM--M-BM?o-?--?--BB-oM--M-BB--M--o---M-EBB-?o---M----EB--BE?-?-BE?-M-o--o-?B--?-BEB?-BEE--??-o-M-E---?--ME-----?-M------MoEo--o-?-B-?-BM-BM-o?-?--M-?oo-oM-B-M-M---B-----B-M-o-foo
-M?-M--oBMM?--M--Mo-M-----BB-oMMM-o?-?-------o----o---B-?------?E?-o-B-M--MB----?B?B-?--M-EEB-B---MM--EM--E-?B???Mo?B-?BEo-B---?oBB--M-----Bo---?BM-EBM-oBo-?E?---?-oE-oB-M-B-oB-??MBMB-ME-?-Mo--ME-Efoo
-oEBo-??M-EoE---oBo-M-BB-M-?M-o-E-E--o--Bo??-o?o----M-?MMo-o-?BoMB?M--o---B--o-?B-?Bo--oME----?-o??-----MM-MBB-oM-----EMMMBo?--oo?o----?BMM-BBEB--o--?-oMM-----M--B-??-M--M?E--M-B--Mo--E-?-MoE--?-o-foo
E-M-o-----?o--?oEoB-Mo--?---o-o-?B-BM-E--BB-BB-MoM----B--M-B-?M--?oMBM?o?-oM-oB--EM--MM?o----?M-o--??M-o--B?--oB-E?-M----oE---E?---Mo-oM-Eo-o-?--?B?Bo-?BEBE-?-BE?oB?M--M-?-T----EEo---o??M?--MBMo-?-foo
MooM--o--MM--o--M-??o----MBMTM-o--E-?-?E---E-----EEB---ET----E--o-ME?--?--M----B---?----oB---E-----BMoM-?EM?--BTB-M-E???o?B----?ME?T--MB--o-?-MMoo-MBM-M-M-M---oB-EB-T-----o|---?---B----B?----ME--o-foo
-oBB-M-----BT-----TE---T--Mo|--M--BEMBB--T-TB-M-E---To??|BoB-Mo??EE?--??MBEMT---?-MBMB-------B--MoEoE----?-T-M-|-T-o--EE----o-M-B-M|-B-?Mo--o---M--EM--M?-?oM-----M-B|BBE?-B|--T-T-o-o-T-o?-o---?BoE-foo
m-EM---EM-o-|BMEB-|BE--|?BBE|-oo??----?B-|M|E-----E-|-oE|-EBMBM-B-M-E?-E?MM?|ooBEB-o-??-E--oo--?-M?B?B-ooMB|oBE|-|?---M-oBE?MoM-MEM|MoME----?-BEEoE?M-?Bo-o?B--MEB?oM|?M?-MB|o?|o|-oo-B|??EoMooo--B--foo
XXXXXXXXXXXXXXXXXXXXXXXXXXXXXXXXXXXXXXXXXXXXXXXXXXXXXXXXXXXXXXXXXXXXXXXXXXXXXXXXXXXXXXXXXXXXXXXXXXXXXXXXXXXXXXXXXXXXXXXXXXXXXXXXXXXXXXXXXXXXXXXXXXXXXXXXXXXXXXXXXXXXXXXXXXXXXXXXXXXXXXXXXXXXXXXXXXXXXfXX
