M?-M-M-ooo-?----?-E--o-BM-?-BoE--B--?--oMBEM?-----?oEE---?E----?---M--?----o--o---E-MB-oB-?M--M-M-M--M--E?-M-M-o-E-B-M?M--M--?B-?--?BMB--------ME---BB-----?o-Eo-?oo---?ME--M-EEMEMoMBB----o-----BM-B-oo
---oBoo---?-M-?---B-M?-BEo-M-MB---M-?-oM-MM-ME-?o?-BMM-o?B-M--o--BoEoo-------EoEBo-----BMo?-Eo?B-Bo-MMME-E-MM--B-----?-?-?--?oM?oM-Mo----oE-B-B-?--o--E-o---Bo?----E---BE-oM-?M-B---o?-E-o?-o---MMME--oo
-----E--M?BB----BM-?---oBM-M---BBEB?-ooE-MB----E-BB--MEBo?---E-BBE---Bo-?o-o---?----EMM-?-BoM-----?E--B----M--M--o-o-M--o-?-Boo?-??ME------oEM-o----MBME-BE-?-?-Mo-ME-ME-?--E------o---?oM-o--?-o---?-oo
-oB---?-M?BB-?B----?-?MEM-M--Bo??M?---BB--M---B-o-E?-??-B--o--Mo?--o?B-?M--?o---B-M?B?M--BBB-?--B?----Eo??-?--M--Mo-B--E-oB-BM----?-Bo-M---EM-?o--E?--M-o---E-?--EB?---M-E?---EMMB--o-MoMo-Mo----B-o--oo
MM?-Mo----?--?M-B-o-?oE--oMBo-E-??-M---o-o--oo-B-o-B-Bo-o--o-B-M-Bo--M--B--o--o---E--M-M-EoE-ME----M-o-EMB-----E--M-MoE-----ooBooE-oE-?M-MBBBBBM--B-?B-E-E----B-MBMB-?-B-B--?M?---?E?-Bo??--MM?--M-oB-oo
--M-?E-o-?MM?-oBMBo--M?----M------MEBEo----Mo-E-E-E-MMo-oo--M--o-B-E-M?-M-M--o-oB-M-?B--E?-?o-MB?B-o--B-M---E-??-Eo--M-B----E-B---oMM-oE?E--M---M-?---BB--BBB?BE--oM-?--o-o----MB---B-?-Boo----B--B-o-oo
--ooM?---o--MMo-?-M-B-B-EM?M?-M?oE-M----?-E-o-?B-o?oM?-o-?--MB--BBoMB-E--M-oBB-BE-----M-?-E-?M--M-------E-------oM-B--M--BE--B-E--o---BB-B-Bo-?--EE-BooM--o-M-B?MBoM----?Eoo-ooM?--E--?E-E-o-?-o-?M-M-oo
?-?---ME---Eoo--------o-----Bo--M--o-Boo--M--BB-oo-?oBE-?E----M---Bo-?-M--M-MooBMB-Mo-EBB-?----oE-E?o--M--o-M--oooBME--EBoBM---B?B-B-?BEB-o-M?-?-??--M???B---B-o-Mo---?-oM-B--M-----?M--o-----?--o?oovoo
Bo-----B---MoM---B--?--oB-BoBo--MMoBoB--oE--Eoo-M-Mooo---??----M-B?---?B-?--B--??-MMEoB?-M--M-?-M-?-o-EEMB-B-M--ooB---MBE?-M--o---M---o-B-M--o-o?-?--B-E---M-----E-E--EoBBM-E-o---oME--M-B?------?-Mofoo
EBooo?o-Bo--M----?o?---?--o--?B-B?o?--EB-?M-BMB?o--EB?-----??-----o-M--B--M---?---ooB-BE-E-Bo--------M?--E-ooo?o?--?M--?B-M-----B----oo-??B--M-B-E??Moo-MB---ooB---??E---M---ooBo-o--oEE-Bo--?M?o--B-foo
-oo-?B--o-oM-o?-----?---o-?E--B-B-BEoEB-MBEM-E--o-o-M-M-o?E--B-BBB?E-B-M-o?-EBB-M-??---?o-o-M---?-EM--?--?E?-?B-M?E-?----E----?--B?Bo-oM?E-?-M----o-o----oBMM-o----B-?---o-BMo?----o---Mo-MB-o--B-oM-foo
--M----Moo?--?-E--Moo?--B--?Mo--o--B?-B-M-?M--E-----MM-M-?-?-??B-?oMoM-BMo-?-M--MMM-----o?B-oo--------oE--?-?-E-?oMB-----?-o--M----BEE-?----BM-o-E---?-M---?--M--M?M----o-o----?M-?oMBo-o-o--B----B??foo
o-EM--M------------M--BBB?Eo-oEBMBo-oo---BoB-MB-oE---B-M-M-------MMooE---o---Mo--?----B--TBB??-o--?---M-?-??M-------BB?oM-EBo-?B-oM--MME-----o-MM-o-EoEE-M------T--o----o--EBMMM?Bo-M?MM----?o--o-M--foo
---E---ooMBE-M--?-o-T-oToE?-??----ooM--T-oME-To--M-oBMM?-o-M-T--??-TM-?--T--o?B--B---Mo--|BBE?-?--E---oMEEoMB---MT??EM-T?-M--B---?BM?B--T-oooBM-?oo-ToM-oMM-MoM-|TE-TT?M?B-?--EB-ToBTBB---T-TE-o?-To-foo
mBo-MB-B-oEMEB-B-EBM|Eo|?-M-BE--BBMoM-M|-E--o|--Eo-o--oM?-EB-|Eo-?-|MMM?B|?-EM-?-o?Eo-E--|?M?-BMM--Eoo--BBoBEo???|oM-BM|BMBoo-Bo?---oo-M|?M--BB-?---|---BMMB-MEM||M-||?E??E?o?--B|--|--MMM|?|BEB-?|E-foo
XXXXXXXXXXXXXXXXXXXXXXXXXXXXXXXXXXXXXXXXXXXXXXXXXXXXXXXXXXXXXXXXXXXXXXXXXXXXXXXXXXXXXXXXXXXXXXXXXXXXXXXXXXXXXXXXXXXXXXXXXXXXXXXXXXXXXXXXXXXXXXXXXXXXXXXXXXXXXXXXXXXXXXXXXXXXXXXXXXXXXXXXXXXXXXXXXXXXXfXX
