--?ooM??Mo-o--MM----EM-o--MB?------BMB??--?M--E-M----M--?B-ME--M----?EBo--BoB--E??o-?--E??-?-B--?----Bo-------?---?M-M?-B---E???B--B?---B?-----M----?-?---B-o?-E-??B--M---B--oE-E------------?---?B---oo
oM-----B---oM?--M?B--?B-oo?-B--?-o?---??--BBB-M-EEBoB--?-----E--M-?E-BMM-ooBM-E?-o---M-?-o-Mo--o--M---M--oo-MM-?--M-M---E-EMM-o-MM--M?-BM--EoE?---B-o--o?-M?-M-B--?M-EoEE---Mo-B?-EEB-o---oB---B-o--B-oo
B----?o-----M-?o--?-oMMM?M----BB---?o--?----?-MoM--EB------B---M-M?---E-Eo-?-o-ooM--B-?-BB-E--BMBBEo-o--BEo-oo?B-ooM---B-EM?---MBM-M-o--?--M---E--?-?Eoo--o----MM--E--?M---?MB-B-MBMBooE-o?-?E-----M--oo
MBB--?M-----MBBoEM-BM-?---BB--BEB?---?-M-EB-oME??-oMo--o-oME-MBoo---?BMMM-E--oMoB?---MB-B?--B---BM?--o---M--B-M-oMB--oMo--o---EM-oB--MB-EB--o-MBE--MMM--o--BB-o-----B??-?-B-E--------BMM-?-oo-?o-BM?B-oo
-oMoBBB---Eo-EM?B---M?EM?B--MM----o-Eo-M-M-o?M?-?o--B-E-o?EM----B?M-B?BB-MBoE----E?o?oE?---EEE-oo-Mo-EBBB--?E?--B-M--?--?--M-B-oB--o--o-----M--MBB-Eo?-?-o?--?-oBBoB----?MM?M?---E---M----M--o-o?--?--oo
o--BB--MEM?M-?--M----?M-?M-o--MMoB--B-M-?--E-B?--o-o?oMB-M-?----E--?----M-EBM-------B---M--M-M--o-EM-??EB--EM-?M--Bo?BBoB-M-BB?M?-M?-o--?oM-?B-o-E?M-o-?-?--?-?-B----o-?--Bo-oEM?----BB-oMMB?-----?---oo
-M?---E-?M-?o?-?E?-?-?--MB?M----B?-M--oBEB?BEM----MMBM-EEB-oBoM?-Mo-E--M-B-B-B---EMo-Eo-E-BE------?MEBBB--oMMM--M---BBM-o--o--oE---?-?BE-M?o--E-o?-M--oE-MB---M?--Mo?BB-BMo-E-B-B-B--E--B-?MM?-M-o--B-oo
o?-M-???-M-M?-?-?--EM--E---?B-EM?-o-?-MMM-M---?M-o-M--o---Eo-----o-MB-MBB---B-?--?BB------M-?BM-MB--B----B--o?E--E-?o?M---o-E?oBB--M?M?B?o?-?---?---E--B-MB-B---oMEoBo-M-M-B?-M-M?M?M--o--o---oB?----voo
B----M?MEoM---B-EMoM-o-BB?---o-B---???o-?-o-MM-oM-?-?-?o-BB?---Bo?-E-M---??o?---------oB?o-?M--M?B---EBM--o?oM---M--BM?-BM--BBB--BM--BM-?-?--oM-o-B-?-?-M-M---?E--?BM?M?o--?E-M--o?B-o-Bo-B-EoMEB--?Mfoo
o--oMEoB-oM---?-B-?--o?-BM--?-E-oM--oEE-M?-BM--o-o--oEo-B-MoE---?----MM-M-ooM---E-o--M?-o---B--M---??B-o-B??-B--?---Eo--B-?---M?-oM----?E?-E-B-EM---oE--?-BM---BE?o--o-o-M----?-EB-o-B-E?ME-B-oB-?-?ofoo
---BE-o-E-oMBM?-MooBB?--E-o----------M---?------o--oM-o-oM??-oo---BME-MBEM-?-o--?-o?M-Mo--M--o?--------M---Bo--E-E-M?-MM-B--E-M------o?-B-o----MoM--?---?o-E-Mo-B------oM-BMB-?--B?---o-MMBo-o-----oEfoo
---?B--o--M-----M--EB-oM-oM--o?--M--o--??---M-o-??o---oo--B?MBME--Eo?-oo-M-?MB-o?-Moo--B?o--E-M-B---o--M??MoEM--M?-?o--M--E---E-?E-----M?o-?E-o----Bo-BB----Mo-??--o---MoM---Mo---M-??B---B?-M-oB?M--foo
MM??Mo-M-?BMoo?MM---o--EMEM-E-?EMoM---BE--ET---?-B-B-MB-B-o?E?-?ooT-oB-o-M?M-o?M--oEEB?ooB-EBB-?BoBM-B--B--BM--E-?BM---?TM-E?oBMB-o--Eo--oo-Mo-BE-o-oM-M-M?M-EB--MM---o-o-o?EE?-EMo-MEEMMM-MBE?o-E-o?foo
Mo---?T---------BBM--?oTB?oTM?-T---?--TM-MM|?--To?-MEEo?--B-TBB-T-|E?--M--o-?-MTBMB?--o-M-o?--BB-?o---M-E-TT?M-To-ETo?T-|?-T-?M-BE-EoM-ME-MT--?o?-T-ooTBE-BB-?BMB?ooTo-ET--oB??---Bo--B--B-Mo?-ooB-M?foo
m-?o--|BB?MEB-BoE??-Eo?|??-|BE-|------|o-E-|M-o|-Mo-?M?Bo-E-|?-?|-|BMM--M-----B|BEB-MEoo----?-B-M-o-??ME-o||B--|-EB|-?|-|Mo|EMMoM?o-M--??-M|-EBEEM|E-B|-M-o---M?-BEB|M-B|-EEE?BM-B-ME--?-Eo?-M?E??-?-foo
XXXXXXXXXXXXXXXXXXXXXXXXXXXXXXXXXXXXXXXXXXXXXXXXXXXXXXXXXXXXXXXXXXXXXXXXXXXXXXXXXXXXXXXXXXXXXXXXXXXXXXXXXXXXXXXXXXXXXXXXXXXXXXXXXXXXXXXXXXXXXXXXXXXXXXXXXXXXXXXXXXXXXXXXXXXXXXXXXXXXXXXXXXXXXXXXXXXXXfXX
