Eo-oE-o-----o-?Boo-BooMBM-E??MB-oB?-?---?--o-Mo--M--BM-BE-BB---EBoMMo-?-oooB-oM---o?M-o-?-?o?-?B?E--B-B---?--BMM-Bo-M-----MM--B?-o-MB----oBMo--BBo--?--MMo-M---?-?---M?B-o--B-oMBMEBo----MBBo?-MME--M-oo
---B-B-E---?MoB???--E--BE?M---o---B?-?-o---BB-?BMM-BMooM----o-BM--?------M-oM?--o?--MEB??-?-E-??-?-B----B?M--M---MMM-oM-BMBo-?-?--MB--oo---B-o-oB--E-ME?BBoo-?--?-BEEBB-?-Bo-?-E-------EM-Bo-o----oEo-oo
E-MEo---MM---?--BMB-----BoME-----o-M?---MB-?Moo-Mo-oM--?E--oo---B?-o-EB-o?--?-E--oE-M---?B-oBoM----------?-oM-B--BM-?o-----MBE--Eo---B-E-o--M-o--B--M--EMMB--ooM?Bo?B-?oB-oooB-M-M-?--oMB-o?---?BBoBo-oo
BooBMB--o--oBMoB?-B-?oM-?--?-oB?EooBB-ooE-o--o---?BM--EB---?----B?-EoM--B--MBMMo--B-M--BM---o-BMoo-?-MB-EM-?-E---o?-BM---o-oMBBoM--B-?E???--?BMB---?-E?-?B-???Bo??-o?-?-?----??MoMMMBoM?-oM-o----o?---oo
--?---?-B-?B?--B------MB-o--B?o--B-?M-?-?o?BEEo-B-o-M-B?EB-ME-o?B-??E---MBB----o?M-B?--?o???-?B?M-oBEEB?---M-B------?-ooM-EBo-E-E--MBM---B-o?M-?BBBo----M?M---B---M--o?ooMEo-----M?--o------?--M---EE-oo
??BB-?M-M-??--Boo?M--?M-o---M---o-Bo------o-M--o?---oB-?----MoMMo-?M---E?-?B?oo----oo-?o--EEM--B-o??-----o--E?M-o-M?B-----MB-MMM-EM---B--?M?M?---M-M??--BB?-M?B-o--B-M-M-o-B-?B-M-?----BEEB?----?B--M-oo
?--B---?-M--E-oo--o-Eo-?EM-Mo-o-o--o-?o-----M?-------?ooEoEE?M?-?M?BB-E---?-?B?BM----MBM-oB-B--?----BB--BB-B-oEE?o---M-?--EMo--?-MBEo---oMMMM-MM-BoEo---?-E-E-o--?B-?-oMoB?EoM---E--Bo?o?B-MEM-?-BoEo-oo
----?-o-M-oB-??---??B-o?------B--o-??-o-------E---B---o?-?-B-?oo-B----Bo--Moo-BBoB-oMB?-MB--??oBoME?ME--B--oMoB--M-M------M-o-EBM-BM---M-?--o-MBoBM----?--M---M-MB?ooo--B--?--Bo-Bo--?oMBME---?E----Evoo
-M-?-?EM-M-E--E-M-oBB?o?-E-BB-o---------?-----M?-E?--B?--?-----ME?-o--B-ooME-M?----?-o-o?-M--EEo-B----?-M--EooMMME-E---B-B-o-M--Bo-M?---Mo?---M--B?M--E-E-?---o--o?oME----MM--o-----M-?oM--B---M-B?--foo
E-o?B-BBB?--?-BBo?-B--?B?oo-M---M??-ME-M-?-E-?oMBM--M-?B--EM--M-M-M??------MBo-B---EM-B--o-M--?Bo-B-o-??-B-B-B---B-----M??-M--?BEo--BM----M-M??-??o-Eo-oMo-o-B---?--?B?M-E----o?o-E---o-?--?MoB-EE---foo
B?----o---B-o-B-----M-E?EBo--B--???E-?Mo--E-oEo?B-o-M--M-B-M-E---?E?-?--o?o----?E-----o??o----BM-oMBMM------?----B----??B?E-BM--B-----M?---oM-?-oB--B?--oBo---B-M-o-EME--M---BE--?--oo-E-BMBB?MBBB---foo
?--M?----?-B--MB---B-?BoBBE?-?o-EM--o-Mo-oB-M---E---oo-B---BEME---M--o-M-B-o?BE--B-M?---o----o?---B--o--EMM------EMMBE--????----M--o-o??-o-MoB?ME?--oEE?--EMoE---oB-BMMo-o-E-E-oE-oM-oo?-o---M-MM---ofoo
BM?oT--E-MMM----B-BM---?E?M--?o-B-BMM--BM--oB----?Bo-EBM--M-BM---E?o-B-o?MoE-B?---MM?MB-?-BoM-T-o-BM???--M?-o-oE--?Bo?---E-o-?E---M?---?EM?EBTM--BM-E-?-?----MB-EBo-B?TBM--?--M?B?--oo-?EMB-o-o---o-Bfoo
-?oT|E---?-o-o?oB--?-TM-T??Mo-B-?o-------oBMBBo--MMBE-MTo----o--oBo-?--o?oo---?-?--B-To--?ME-o|--MEo?o---EBoM-TM-?EBMT---???T-TB?ETM---TBBBT?|T----B--oM-M-MMT-?M?-M--|BT-Eo?Bo-EM--E-T----B--TBM-M-ofoo
mB-||-Eooo--?Mo-M--?-|-?|E--BBM-M---?Bo-?-B--o-MB??oMMo|?MEEM?-M---oo-MM-B-oB-BM-?-E?|-BE?oMM-|?-E-??--ME-oEE-|?o?M?-|??M--o|E|M?-|-BoB|o?o|-||--M---ooMM?BEM|o-?-EB-M|-|-B-BE---??M--|E---?-?|-oo-M-foo
X----------------------------------------------------------------------------------------------------------------------------------------------------------------------------------------------------fXX
