--EMBM---?-oEME-?oMo-o---oB-E-?o-------B--E-oBE-E-?-Mo--M---o--o--M--BB-----o?B-oME?ooB-M-M--?-MoEoMM----MEB-??BM-B--M-Mo--E?o?oE-o?-o--M-o?oM-BMo-EB?-B-o-o--B-B-??MM------E-----MM?--B?M?BoBBoM---B-oo
--B-oEE-?--M--B-E-----?E-EB--oM-B-M------?-?BBM-?-M--B---B-M-M?-Mo---o-M----oM-----E----MM-M?B?E--M?-o--Mo-BME----M--o-EMBoMM---B??-oo?-M--?--oB--oM---E---EM-?-?B-?---??BoB-E----??E?---B--E-M--BE-o-oo
--M-M-B--?--o---B-----EM-?MM-o-M-?---oooM----?-?--Bo-B?----MoM--B-?-B---o--o-B?M-M----BM---BB-MM-B?-B?----o-?B-E---??--M?MoBBoEoM-oo-EMoo----o--M--B-oM--E--M?BM--BM-----BE-BBo---BMM--?oo--BooMBoMM--oo
--E--MMo?E----B-?oo--oB-?BE-EBM-------M???--MB--EE?BBE------o-M-?----oM?----BME---MEo--?-M?--oB?-o?--EM--M-o-B-??---MMM----?B-M--?M--M?-?-E-M--M?-BM?----?-?-----o-B??--B----EEMB---oo?Eo---B-M--B--B-oo
?o-Mo-B--M--M---???----oEM?M?--B-B-B-M-MM--E--M--Bo-?--Bo?B---M--??----MMBM?--B--?M--o---B-E---oo???E-Bo----E---B-o-?E-???E-o?-E--?-M?M--BBE--M--M-o-EBo-??--MB--oBo-M--?o-oEBB--Mo--------M----?E-E--oo
oME--M--MMBMB--?-?-BE-M--BE--B---?-MMooBoE-M?MM-?-o--E?M-EE--??M--o---M--?M--M--MEM-oMM---oBE--B-M-MM--?Mo-?----oB-ooBo-o-MMoo?B-B?-oooEE-EBE--B-----?-?--M--?MM--M-?oMMB--??E-?-B-oo-?--o---o-MM??---oo
-M-o-M---?---oM-M?o?--Eo?M?MB--M--M??---E-?BBBBooo--?--M-BM--oM-?-E----o----Eo?---B-B-??--MB-?-oE---EB---Eo?--MM-?-B--E--oM-----???--EM--o-M--B---o-?-oB-?B---BM-BBB?-??--BM?--MoBE-----o?ooE-?-----M-oo
B-BB-?M---B---B?---M-?---B--?-M-?o----B-?-o----?-B--oooo?B?B----Eo-M-M--o---M-MMM---?-Moo--oB--M?----BoooM--BBM-?---Bo---?-o?B-MM-??---?----o?M-B-E?MMM-----o--Bo--B-M----o?-Mo----E--o---B??----M---voo
BBBEoo---??BBoo-?-?-B-E--?Bo-M-?--o-MM-M-MB-----oM-??--o-o---?----?-----B----o--E??------oM-?--?Bo--M----o-B-MMBoE----Bo?-E--?o--M--??o--B-o---?-EB?-----o---M--?MBE-----EBB---?-?B?BooE----B--B-?o--foo
----?--B?-M-M-B----E-BMoE-M--o-B-B--------BBoB---M--ME?B----oo-BE-Mo-B-EBM-BEME-M-?---?-M-Bo?-BE-E-BM-EMo?oBE-MoBMoo----MMB---BE?B-o?E--E-??BoB-?M---Bo-MoBE-M---B??--EMM-oMMo?oMBEB-??B?-EoM---MoE-ofoo
---E-B--E-E-EMB-?--M------ooo-MM?-o--?-Bo-o-o--?MEM-oBBooo-?-B?EMoM?---M-E--BM?-M--M-?oBEo-M--EB-MM?-o-M-B---BB?--?-M?M-----M-M-----M?--B??E-----o-B--?--M----?oMB?---BEB--M---oo-BEo-MM---?o--MM-?--foo
--M?Bo--MoME-E--BM-??Bo------?--o-----B-Eoo-E-oBMB--B---o?---EB?-oo--oMMo---oBB-o--B-M--BM-o---ME-B-?MBo---o-oEM-EMo-??-oE-B??MBMo-o--M--MB?---B-oM-ooB-M-o------MBBB?--M----Eo-E--?--?BE---MMoE-MMo?foo
--??-oM------?EEMB---B-?----B-B---BB-----B?--?B-?-EBEBB--?-E-?-?Eo-B-B???o?-o--E-EEEEM-M--MM--?--o-M-M-------BB-?-?--oEo-M--MB?-----B-EB-oM-B-MB----BMM-?-E-?--o--?---B-?oM-oB-----?o-o-?M--o?o-BM-M-foo
-Mo---o--E--M?-M--T-M?TM-MM?-M-M---?Eoo---BoM--o?o--BoBM?-oBT-oE-oBMTTTB---?--?--T?--EoE-o-E-?-EMo-----?-E--BM-?BMTo-TMMM--E-E----T-oo?--?MT-????-Mo--o-T-T-?o-B---M--To?--oBTE--T?o-----?--?o-T-o--Mfoo
m--B-oBME-BBoM-BBM|M-?|--oE??M---?M?-?-M-B--M-MoM-?-?EE-E?--|-M-M?oo|||---oB--BB?|-B-B--E-E-E?B-?M-BoEEM--EE-?o--o|B-|Bo??-?---?--|E?-B-MEE|oM?-----M-M-|-|EB?oBE---M-|BooM-?|--o|-MBM-E--?-?E-|o---ofoo
XXXXXXXXXXXXXXXXXXXXXXXXXXXXXXXXXXXXXXXXXXXXXXXXXXXXXXXXXXXXXXXXXXXXXXXXXXXXXXXXXXXXXXXXXXXXXXXXXXXXXXXXXXXXXXXXXXXXXXXXXXXXXXXXXXXXXXXXXXXXXXXXXXXXXXXXXXXXXXXXXXXXXXXXXXXXXXXXXXXXXXXXXXXXXXXXXXXXXfXX
