------------------------------o---------------------------------X-------B------????????----------------------????-----------------------------------------M---------------------------------------------
-----------------------------------------BBBB-------------------BB---?---------X-----X-------------------------------------------------X-------------X--------------------------------------------------
---------------------------X----------------------------------------X-----------------------------------------------------------------------?----??????-----------BBBB-???????--------------------------
---------------------B-----------------------------????????------T--------------------o------o----------------?------T----------------------------------M-----------------------------------------------
---------o---------M-T---------B-----------------X---------?-----|-BBBoBBB-------------------------------------?---B-|------------------------------------------X---------------------------------------
-----T---------------|-------------------X--------------------T--|------------------------------------------T------M-|---X--T--X--------M--------BBB---oT------X???X?-------B---------------X-----------
-----|---------------|X-------X---------XX----------X--------?|--|-------------------------o----------------|-------T|---XX-|-XX------------------------|-----XX--XX-----------------------XX-----------
-----|---------------|XX-----XXXX------XXX-----------------X--|--|---------T-B------------------------------|-------||-X-XXT|XXX-----------M-----o------|----XXX-XXX----------------------XXX----------v
-----|---T-----------|XXX----XXXXX----XXXX---------T-------XX-|--|---------|-----T------BBBBXBBB------------|--To---||-XXXX||TXX---T-----M---M----------|---XXXXXXXX---------------------XXXX----------f
-----|---|-----------|XXXX--XXXXXXT--XXXXX---------|XXX----XXX|o?|???X??-X-|-----|----------XX--------------|--|-?--||-XXXX|||XX---|--------------------|--XXXXXXXXX------------------?-XXXXX----------f
-----|---|-----------|XXXXX--XXXXX|-XXXXXX--X------|------oXXX|--|--XX----X|-----|---o------XXX-------------|--|----||-XXXX|||XX---|------BBBBBBBB------|-XXXXXXXXXX-------------------XXXXXX----------f
-----|---|-----------|XXXXTX-XXXXX|XXXXXXX--XX-----|-------XXX|X-|-TXXXX--X|-----|-----X----XXXX-------X----|--|----||-XXXX|||XXX--|-----------?---BBBB-|XXXXXXXXXXX-----------------XXXXXXXX----------f
-----|---|-----------|XXXX|XXXXXXX|XXXXXXX--XXX----|-------XXX|XX|X|XX----X|X----|-o--XX---XXXXXX------XX---|--|----||-XXXX|||XXXX-|-------------------B|XXXXXXXXXXX---?--M----------XXXXXXXX--------??f
-----|---|-----------|XXXX|XXXXXXX|XXTXXXX--XXXX---|--o----XXX|XX|X|XX----X|XX---|---XXX--XXXXXXXX-----XXX--|--|----||-XXXX|||XXXXX|-------------------X|XXXXXXXXXXX-----T--????----XXXXXXXXX----------f
m----|---|-----------|XXXX|XXXXXXX|XX|XXXX--XXXXXE-|---E--oXXX|XX|X|XX----X|XXX--|--XXXX?XXXXXXXXXXE---XXXXE|--|---E||XXXXX|||XXXXX|----EEE-----------XX|XXXXXXXXXXX-----|-----E---XXXXXXXXXX----------X
XXX--|---|XXXXXXXXXXX|XXXX|XXXXXXX|XX|XXXX--XXXXXXX|X-----XXXX|XX|X|XX-???X|XXXX?|?XXXXXXXXXXXXXXXXXXXXXXXXX|XX|XXXX||XXXXX|||XXXXX|X----XXXXXXXXXXXXXXX|XXXXXXXXXXX-XXXX|X----XXXXXXXXXXXXXXXXXXXXXXXXX
