----BBB?BBBB---?----------------------------------------XXXX--------o--o---X---B??????????-B----------------B--------------------------------BBB--------------------------------------------------------
-------------------B--------------------------------------------BB---o--o----------------?-?-----------------------o------------------BBB------------------------------------------------???------------
---------------------------------------------------------MB----?----X-----------oBB-XXX-BBMBBBBBB-----M-------------o-----------------------------------------------------------------------------------
----------------o----------------------------------?B??T???---------T-BM------??????-o-M--M-B--M--------------------------????--------------------------M---------------------------------------XX------
------M----------T-------------------------------------|--B--------B|oTBXB-B--------------o---oB-------T------B---------X----------------------------------------------------------------------o--------
-----T-----------|-----------X-------------------------|--M---------|-|XX----------T----T-T-------o-X--|--------X-----------------o------------------------------o--------------------------------X-----
-----|---X-----T-|------X---XX--------------------B-X--|--M--?-X-?--|-|XX---T-----?|X??-|X|o--X----TXX-|--T???X?XX----------------------------------------------------------------T----M----------------
-----|---TX----|M|------XX-XXX-------------------------|---X-XXX----|X|XX--T|Bo---T|XX-T|X|----M---|XXT|--|---XXXXX----X---T-------B--X--------o--B-----------------XXXXXXXX------|---------T----------v
-----|---|XT-T-|-|------XXXXXX--------------------????X|XX-XXXXX----|X|XX-T||-----||XXX||X|X-X---M-|XX||--|T-TXXXXXX---XX--|---------XX-----------------------------------X-------|---------|------X-??f
-----|---|X|X|-|-|BBBBB-XXXXXX------------T--------XXXX|-o-XXTXXBM?X|X|TXX|||-X--?||XXX||X|XXXX----|XX||XB||B|XXXXXXXXXXXX-|--------XXX-----------------------------------XX------|---------|?-----XX--f
-----|---|X|X|-|-|-M----XXXXXX------------|------------|??oXX|XX--XX|X||XX|||TX---||XXX||X|TXXXX-XX|XX||XX||X|XXXXXXXX-XXXX|-------XXXX-----------------------------------XXX----X|---------|o-T---XXX-f
-----|---|X|X|X|-|-----XXXXXXX------------|?-----------|-MXXX|XX-XXT|X||XX||||X---||XXX||X||XXXXXXX|XX||XX||X|XXXXXXXXXXXXX|------XXXXX--------------------------------o--XXXX--XX|---------|TT|---XXXXf
-----|---|X|X|X|-|----XXXXXXXXX-----------|------------|-TXXX|XXXXX||T||XX||||X?--||XXX||X||XXXXXXX|XX||XX||X|XXXXXXXXXXXXX|X----XXXXXX---------X-------------------------XXXXXXXX|---------||||---XXXXf
-----|-XX|X|X|X|X|---XXXXXXXXXXX---------?|----T------X|X|XXX|XXXXX|||||XX||||X--T||XXX||X||TXXXXXX|XX||XX||X|XXXXXXXXXXXXX|XX--XXXXXXX-------TXX-------------------------XXXXXXXX|---------||||---XXXXf
m---E|---|X|X|X|X|E-XXXXXXXXXXXXX---------|----|-E--EXX|X|XXX|XXXXX|||||XX||||X-E|||XXX||X|||XXXXXX|XX||XX||X|XXXXXXXXXXXXX|XXXXXXXXXXX-------|XX---------E------X-E------XXXXXXXX|----E-E--||||---XXXXX
XXXXX|XXX|X|X|X|X|XXXXXXXXXXXXXXXXXXXXXXXX|----|-XXXXXX|X|XXX|XXXXX|||||XX||||X-?|||XXX||X|||XXXXXX|XX||XX||X|XXXXXXXXXXXXX|XXXXXXXXXXX--XXXXX|XXXXX------XXX?XXXXX--XXXXXXXXXXXXX|XXXXXXXXX||||---XXXXX
