----------------------o----------------------------o------------------M-----------------------------------------------------------------------o----------------------------------------------------BBB--
-----------------------------------------------------------------------B-----------------------------------------------------------------------------------------------------------------M--------------
------------------------------------BBBBBB----------------------------------------------o--BBBBBBBB-------------------------------------------------------------------------------------X---------------
--------------------------------------?------------------------------------------------------------------------------------------------------------------------------------------------------------XXXX-
--------------------------------------------o------------o------------------------------------------------------------T------------------------------------------------------------M--------------------
-------------------------------------------------------------------------o------------------------T-------------------|----X----------------------------X---------------T-----X-------------------------
-T---------------------------------------------------?-------------------------M------------------|-------------------|----XX---------------------------XX--------------|----XX------------------??-----
-|----------M---------------------------------------------T------------X--------------------------|-----------------X-|----XXX--------------------------XXX-------------|--XXXX------------------------v
-|-------------------------------------o------------------|-------X----XX-------------------------|-------------------|----XXXX---M--------------X------XXXX--BBBBX-----|--XXXX----o-------------------f
-|-------?--oX-----------------------------------o----X---|-X----XX----XXX------------------------|-------------------|----XXXXX-----------------XX-----XXXXX-----------|-XXXXX-----X------------------f
-|----o------XX-----B-------------------------------------|-XX--XXX----XXXX-----T-----X-----------|-------------------|----XXXXXX----------------XXX----XXXXXX----------|XXXXXX----XX------------------f
-|-----------XXX-------------------------------------X----|-XXXXXXX----XXXXX----|--X------M------o|-------------------|----XTXXXXX-----------MB--XXXX---XXXXXXX---------|XXXXXX---XXX------------------f
-|-----------XXXX-----------------------------------XX----|-XXXXXXX----XXXXXX---|-XX--------------|-----X-XXXXXXXX----|----X|XXXXXX----T---------XXXXX-oXXXXXXXX-------X|XXXXXX--XXXX------------------f
-|---X-------XXXXX---------------------------------XXX----|-XXXXXXT----XXXXXXX--|XXX--------------|-----XX-----o---???|----X|XXXXXXX---|-X-------XXXXXX-XXXXXXXXX-----XX|XXXTXX-XXXXX------------------f
m|--XX-------XXXXXX-----E----------------------E--XXXXE---|-XXXXXX|-E--XXXXXXXX-|XXX---M---E---E--|-E---XXX-------E--X|----X|XXXXXXXX--|XX-------XXXXXXXXXXXXXXXXX---XXX|XXX|XXXXXXXX---------E-------XX
X|XXXXXXXXXXXXXXXXXX------------XXXXXX---XXXXXXXXXXXXXXXXX|XXXXXXX|XXXXXXXXXXXXX|XXXXXXXXXX--XXXMX|XXXXXXXXXXX-------X|XXXXX|XXXXXXXXXX|XXXXXXXXXXXXXXXXXXXXXXXXXXXXXXXX|XXX|XXXXXXXXXXXXXXXXXXXXXXXXXXX
