BM?o--??--oo-oM---M--M--MBM--?-?Mo?E--B---MB-------?------?o--BE-----?-Bo-o--EEM?-o-?-BBo--?--E-M--M-?----?B-MoM--Mo-M-o--MEBM?M-BBoEE-o-MB-oB?B-MMBo--BooM---B--M??-Mo-B--E?---M?-M--E--------o-MM-M-oo
--BBE---M-E---?---E---?--B-E--?----?-EBB----M--EM?MoM------o-M-----E?ooM?E-?-M-o--o-E-o--MM------M?oooo--M-BoEo--o-?----oM?-------E--M-M--??-oB-oB--?----EE-BB----?Bo---o--M----?-E---M-??oM-?--MMoMM-oo
-o--M--o----M-?M----?--E-BB-M-B?-Eo----oME--Mo?-?E---?M----B----BM-BM-EEM-BMEo---?------B---Mo-E-B?-M?o--?oM?-o-MM-o--B--E-EBo-M-o-M-o--MM-E-o--M-M--oE-o--E-?oB-M-M?-MM-o--ooo---BBB-------MM-B-BM??-oo
-MB-MEo?--B-?----o?o---?Mo-EM-B--B----o---Mo-oBM---?M-?--?---??-Bo---BMM---B-?o--M---o-E--M?-o-?--?-B--o---oM----BB-E---?B-ME?B--M---B-M?-o----E---oBBMo--E-?-ooo-MooM-B--oM-E-?M??-M?-----Mo---BM-?--oo
o-??-B--?M?E-???-EM--oEEM-?---?M--o-?-BoE--B-?BMo-B?E-E--ME---o--ooBo-M-oBBM-M---EM-M--MB-----?o-B-o--o-----o-E---?M?B-MME?-?--MMM-??o--o--M?-M--M-M-B-M?-M---?--M?oM--?E-o?oM------B-M?-B---B-MBE-Mo-oo
o-----oo----B?oo--?EMM??E----MMoBB-?---MME-?-MB---BE--M-BBM-oM-?-B?-----M-M?-----BM--o-?E--B-o---E---M-----?B-B--Eo??----BM?------?BMB-B--M-M-M-oo----oM--B-B-MM-M-oMMoMMEM--E---?EoE---?B-MBBo---o---oo
-oE----M-Mo-o--E-E---E-?-----?M-Eo?-EEooM-EM--?-M--M-------?--?--BM-M--oE---?-o?BMB---E--MoBo-B-oMMM-o----?--M---ME-----?M?-E-?----M--B------Mo?--E--?B--?--B-M?-------EBB--BM-B----MB--o--?o-BB-Bo---oo
o-?-------o?oo---B-M?----?---M-E--?-BM--o?---B---M-Mo-?Moo??EE------oB-?-oMoB-M-B-o-o---o-oB-o-M-o???-?--Eo--o??M-B----B--E-BEE-----B---E?----EEE-----?-o-BM-------M--EME?-o-???-oEEB--M--BBoB?o-B-MBvoo
B-?Bo-Eo--o?---?-Eo-EM---E-o---M--o----M---Bo-o?BE?Bo---M-o--B-?--o---oB-M---M?B-----??B?--BE-----BB?-?M-Mo--MB--MBoM--BoMM------M---E-oB?--?-M??E?-o-??---M-E--EM-?-BBB-?-M--M-M?MBE??----o--o--?-?-foo
--oB--?--?BB-oE-o--BB-B----BBo-MM?-o?o--o----MoEB-?B?o----B--M--Mo---M-E-Eo?-oMMEE--M?o--E--B---MoM-M-BB?B-MoM--MB-BEE--M-oMo--o-MM-o---Eo---Bo?EMBBM?--oo-------oM--oB---Eo?---M--B?-----o-E??-BM-M?foo
---MM-MMB-E-MM-------o--??---M----?-?Bo-B-oo----EE-oBMM--B---M-o-E-o---BMBM-o?-BB?E-E?---?--MB-?-Mo--?BBMoE-B--o-oB-BB?ooMBMM-B------B?oM-?--BEMB--Mo-MoM-M?-B--BEE---B-M-?--?BEMMoE?-EoM-B-?--?BBo?Efoo
M-MBB-M--B-E-----MMM-M--ooM-E-B--B-B--M--????-oo-B-E--?--B-B--E?-M-ME-?-?o--o??MoBM-M--o-oo---ooE----B--M-B-?-o---M-B-MB-o?--MME--?E---E?---o-?----B---?--B--?---?-o-MMB-E-M--MM----?EM----B--o--??o-foo
?-o-Moo--M-M-oo?BM-oMo--E--BMEMM-MB?-B--?---o--??-o-----o?BM?--ME---M-E?BB--o--?--??MEoMTBE-B-M-BBBEo--M-B---B?E---ooo------B-E-BBM-----E-TB-M-o-E--MMo--E-----?-MM-B---o----oTo-B----BE-o--??MTM?--Mfoo
Bo-oM?ET--?-TEMM-o?-BB---?-M--MTB-oMo----o---M---B-ETo--E?--MT-o?-------MMETB-TB?----MBB|-----?--?-BEE--T--oEBET?o-BM?--BB--TE------o---?-|EB--TM?----Boo----B-?ToT-TT--??-o-?|??E-E--?--E?-o?o|---Bofoo
mo---B?|----|-?B?-??-B-o--MB-o?|----E--ooEoo-oEM?--M|o-o?BM-o|oM-oo?MB--?EM|B-|-B-oooB-M|MoEMBMEBB--?MB-|---BB-|-o-M-BBMB-o-|-BBB-E?-oE--M|---E|EE--?B-M-EE--oEo|M|o||-E---B-E|Bo-EB--?ME--o?-E|BB??-foo
XXXXXXXXXXXXXXXXXXXXXXXXXXXXXXXXXXXXXXXXXXXXXXXXXXXXXXXXXXXXXXXXXXXXXXXXXXXXXXXXXXXXXXXXXXXXXXXXXXXXXXXXXXXXXXXXXXXXXXXXXXXXXXXXXXXXXXXXXXXXXXXXXXXXXXXXXXXXXXXXXXXXXXXXXXXXXXXXXXXXXXXXXXXXXXXXXXXXXfXX
