?oEo?BMBBMBE-MB??EMo?oM-o?o--M-M?Mo-B-oEE-M?ME?B---o?o---MM?-B--?o-M-BMo---EEMB-M?M---oB---?o--E--BBM---M?--?--E--oBM------?---?M-o-M-B---M-B-----M???-Bo-M-B?-o---?--BoM-MB-oEBBE--BB-------o-?M-E?B-oo
ME-M-BMBB---------M-??Bo--B--M-?--BB--BB?o--?---ME---E--BEo?o--E--?---E---MB-M-??B??BE-Mo-----?BB--E-----MME-B?M-M-M-E--BBM-M-?-MBo---E-?oMMB---EEoBB?-B-M?Eo---?ooMoBEE----?--B-B--?E?B-E?---M?Eo?E--oo
EBM----?---E-B?------o--?----?EB--M-M-M?-E--?-B-o---M--MB-??-----?--B-B---M?-oM-BE-M-?--?BM-B-M?M--?--?B---BBo--M--?-M-M-M-B-oB-?---E---o-oB----B-B------?oBB-B---E-o?--M-o--?---M-M-?-BB-MM?--B?M-M?-oo
M-----B?---?-oM-M-o-Bo---BB-o-B-B-----oB??E--o-oB-----B?-o?-o-M--E--???M---E------o----o-MB-M-BB-oo-Bo--E?B??o--?-BoB--M-M-M?-B?MBEM--?---?-MoE--M-BBE-----M--?---B-?MM-----oE-o--?B-E-Mo-EB--o-----M-oo
o?M-o-?Eo-?-E---B?oBo-?-?oMMM-?EM??-Mo---E-o-o-----EB-E-M?---?-o?--Mo-M-B--?oB---BEB-oB?--M-?o---M-M---B---oB-oBE--BMo---BME--E-ooM-B--o-------oo---EM-?MEoEo-M?oB?M?-B--BooBB-oE------?-oBMM---o--BB-oo
BoB-M?oB---?---?-?---o----?BEBE-M--BMBM?o??--M--o--?--B---M-Bo-B-MoB---ME??--E--???--E-E-----?-oMEBM-o-o?o-oB--?-M-MBB-BB-oM-o-MBM??B-?EB?--M-M-?-B??--B-BoBB--?--M-B-EEBMo--M-BB---o----M--M----B-oM-oo
-B-B-o--?--E?---?BoB--oB-E-?B??MM---M-M?-??--o--B-?---B---BoB?-BMo------Mo-?-?-M---?-M-??M-oE??o?-EB-M-B----oM--B------E----?-o?-?M---?-E-BoM-----o-----oo--B-?-?--B-?B?--?-oMBB-MM???----M-M-?--o-M--oo
M--?oE-BBEEM-o-MMBMo---MM?-E-BMo?B-Mo----?M-M--E--?o----E----M?E?oM-oM-oE-o---Eoooo---oM-?M-M--M--B-Mo---M-MBo---E-------M-------?E-M--oM--?--B-EBE----o-E?Eo-MoM--?-???---o--E--?B-----?--M-oBEo--MEvoo
---?-M?M-MM-o--oMBBB--oo-MB--M-B-oBEBMB-Eo?-MoM?ooEo-M?-?E-oME-----o?B-MB-M-?B--?--o--M-o-B---?---M?M---MBMooE-o-??-ooMB---?B-BM--M-oM-M-oM-E-oE?E--B---?-MMBo--E----?B-B-?---MMB-o--EE??--BBoBBE-MEMfoo
B?o-oE-MB--oEMB-o-o--M?-BBE-?---EoBB----??o--EoM--M?-M--BB---?--o-B---o---B---------oo--o-M?---?M---BE?BB--M-M-oo-----Mo-M---E---o--?-MM-M--?--?-?--------M-EM-M?-Mo-?--BoM-Mo?M?-M--M?-EM??-E--?-MB-foo
E-o-----?--?-M-M?--E--?EBo?--B--B---E?-------M?E--B-o?E--B--ME----EBE---B-oMBoM-?B?-oMMo--B-M-?--B----B?-o-oB-Mo-o-B-o---EBM--?--BMoEoo-B-oM--Bo-B-----?--MM------?-E-?-?---o-?B---B-?E-B--o-M-E-----foo
M----B?----M---EB-o-?o-----B-M-o-B-o-?---B?o---B-o---EBM-?oB--o-?-?-BM-?oM-B-B-o?oo-?B?Mo-MB?ooBB-?-BMM-B-o----??-MB-M--oM-M--B-oo--B-----BB-o-?--o?-oB-oo?-??B-M--M?-------EEoMBE---??EM-----BM-M--?foo
-oEB--o--o-?E--??To--TM--BMM--o?MM-?-Eoo-EB--o-B--------M--TMo-BoEoMo-o-B-MM-EB-MM-o--o--Mo--oo-M---?---B-M?Eo-M-?M-o---EBE-?---?B-oBMo-?--E-B-M?oMo-MM??o---o-oMB?-B--MB-MMMB-oBM-Eo-o--E-E-----o---foo
-E?-MT-M---?--T--|M-B|B-MB-?---TBM-------B?-B---BTM?--M?T-o|-M-T?--B-T-?--??-T-TBM-MBB--EB----EBo?-TB?ME-oB?--o--o?--ToM-TTMoEo-BTM---o--ooBo--o?-TooE-?-oE-B---??E-T--?B-T?M---ETMM?M-oB-EB--E-?-T-Efoo
m-E-?|o-o?--o-|-E|?oo|BE--?o--B|-?M-?-??Mo?-?--ME|Eo---B|oM|M--|-E?EE|o-?--o-|?|---oMM-?M--EBBB-EM-|M---o?M-B-EEEoMo-|-?-||EEM?-o|EEEBB-B---MB?ME-|-M?-M---oEo-???Bo|Bo-?o|MB----|BB--Bo?o?Boo?Eo-|--foo
XXXXXXXXXXXXXXXXXXXXXXXXXXXXXXXXXXXXXXXXXXXXXXXXXXXXXXXXXXXXXXXXXXXXXXXXXXXXXXXXXXXXXXXXXXXXXXXXXXXXXXXXXXXXXXXXXXXXXXXXXXXXXXXXXXXXXXXXXXXXXXXXXXXXXXXXXXXXXXXXXXXXXXXXXXXXXXXXXXXXXXXXXXXXXXXXXXXXXfXX
