--?-o-BE--E-M--E--Eo---BBM----o---o?oBo?B-EB-MM-M-EM-M------oo--o--B-?-EoBB-EE?--B-B?MEM----?------M?-?E-E--B?oB?-o?--??M--Mo-BM?--B--E-?E?--MB?--oM----BBM-?--M-o?ME--B--MoBB--?-?ME??-EoMoBEEo-BEM--oo
o?--B?EM---M-?oB?o?M---M-?--oB-o---M-?-B?oB--o??--?--?-oBo----?Bo-?---oM??---B------E-MB-EB-E?---Mo--E--?---M?---M?----?o--B?M-M?-E---?--?------B-?-?Bo---o-Mo--?M-BM-??---M?-M-o---BoM-?oE--MB--EM---oo
-M?-B-BM-?-E----oo-o---o-E--MMo?o--EB-EM--Bo-o-M--?-----?---B------oB?-M??EM-???-M?-----o---??B--oMo??B-?--B?M-?--o?--M-E--oM--o-E-MB-?----Eo--o--B---E-MMB----o?o-?-oMEo--oo-B?o----BBMEM-o-E--M?o---oo
--MoM--MEoM---M?--E?--------B-EoM--MMo-B?---Mo-B?--?E?-o-oMMEM-----Eo----?B-M----Bo----M--E-M-o--o-?--?BoB?-MEB-M--M---B--o-o?--?-o---?EooBB--E?-------BM---ME---MB---?--?EB--?-Eo-?-Bo-B--B-?ME--BBM-oo
EE---o--Mo-?-E?-M-M----o-B?-?--??------E-MM--E------M-oo-M-B---M--o-oEBEo?ooBE-E---?oo--?-?EoM--?--??o-?--Bo-?------B-?---M--?---o----?----??----M--?M?B?-MB---o-EEoM----E?--?-B--B-M-M--?--B----?B---oo
M?--M?-oBoBM-?--M-M--?BBBB--o--B---B--B-E-o-?-----oM---oM-B-B-EE-E-BMB-?B--ME?--MB-B--o-EM-BM-----E-M-?MB---BB--o-BM-?o?o-?--o--?---B--B-EoM-o--M?-o--o?M-B?-B-B-B-M-?-ooM-oE-BE?--M--EMB-ooM--oMM-oE-oo
Eoo-oMo-o-o--oE--M?-Bo--MMo---oE?-MM-o--M--?-oo--?-?B?o---?E----M-E-o-o-o--o----EBo--oo-?B?-o-oEBoM-M--o---?M---MB--B-ooMM-?-M----ME-B-?M----o--MBEBo-?EM-o-oE-?--o----Mo--M-BB---E--E-oM---E--BoB-?B-oo
?-B-----o----o-E--M---o-M?o---?B-oo-oE---ooE---M-o---?-E-o-B--BM-MM--MBBoo-M?--B-B----E---?oEEB---M?--MB??-?o-E----M--?M-B?B-E-B--?Mo------?-??M-oMMMo--?--ooMB?---?B-oB--E?M-B?-?B---M-----M-oMo--M-voo
B--oEoB-?--M--o?----MBME-oo-B--?B----M-BE--B---M--BM-Eo-BB--oM-E-o?B-B-E?M??--M---Mo-E?--E-o-B-BM?--?--M--oB--?E-M??Mo-o----oBE-B---MB?----oE-?M-Mo-MME--EoB---MB--E--E---B--??MB-Boo-MBM--?-E-?-E---foo
----BBo--B-o--M--EM--Mo----?----?-Mo--?--Mo-?o----?-??------??M-----B-----M--?M-?-o-oBo-oMB-?EM---EMBE--o-------MBoM-----E-B--BBM-M-EM-----E--oE?E-?---B-B-M-oMBo-B-B-MM-??--M?o--?--E?MBE?-?-?-M??MBfoo
?E-B--E-E--EBo-M?B-BB-M----B-?M--M--M?Mo--?--E-o-?ooo-----??---B-o--?o?ME-o----M---BM------??-?o--??------MMM-MMooo--?-M-Mo-E-??---M--E--E-???---?BM-?--M-E-o--MME-M??-B------M--B--oB-E--BM?----M--ofoo
BMM-?-BB?o-B?-BMME--?-BM--?-oMB---MEB?---B?--M---??-EE-M?-Eoo------?o?B-B----o?---?ooM-----?----o--?M--Bo-M---MBo-MMM-M--??EB?o--?M?----B--??---?M?o-oE--??oM?-o??--MBBM-BoM-ooM-----o-?--Mo--TBE?---foo
?o-o-??-MBoEToo-?M--B---M---oo?M-??----M-?o---oE-?---M-E??B-----EBM-Bo-?---B--M-?E----B??B?ME-o-E-E-E?-o-BBo?E-o???-BB-B-???Bo-oM-Bo-M-------oB---BEE---B-??--?B--BoMBoo--MM?B--o---o---B?E-E-|M?BooMfoo
oTBEET?oE-oB|B----E--ooMT--o??BBTE--?o-BBMBoo-B?T-ooT--B-?-Tooo-M------TE-B---B--MT-B?-?--TT-?M?B--EBT-----B-BTMEM-MTTM---MoEo-M-BTo--B-?o---M?---TBM--?--B?M-?-??--?Mo-M-M-TBo--B-B?-B--M----|EooT-Tfoo
m|o-B|-B?ME-|-M-MEMoE-Bo|--?o--B|???E?BBMM-BM--M|EEM|M-B?o-|Bo-?M--o-o-|BBB-B--?--|-EB----||ME?---oBo|M-?-M-Mo|?-Bo?||?MMo---B-E-M|----oB-oM?-M--o|E--Mo---BBEBE--E--BEo-E--|-M-B-oME--BM--M-M|-E-|-|foo
XXXXXXXXXXXXXXXXXXXXXXXXXXXXXXXXXXXXXXXXXXXXXXXXXXXXXXXXXXXXXXXXXXXXXXXXXXXXXXXXXXXXXXXXXXXXXXXXXXXXXXXXXXXXXXXXXXXXXXXXXXXXXXXXXXXXXXXXXXXXXXXXXXXXXXXXXXXXXXXXXXXXXXXXXXXXXXXXXXXXXXXXXXXXXXXXXXXXXfXX
