-?-?B---o-ME--MMB-o--??ooB-o--o--oB-?EM--?--M------BMM?oB----?-M-o-BBM-o-Mo?B?MBM-BBM-ooMBM--?o--E-oo--oo-EEEM-B?E-E---Eoo--B---???B--o-B-E---?BB-o--oB---?M-M?oB----M----B-B--oM-M-B--E-B-?--MB-E--M-oo
-?M----B?-----E--o---?o-------MBB--Eo-?-M----EoB--?----??oB-E?o-?E--M----B-M?---o-MEBo--?-MEoM?B--M?-E-BB-?M-M?-o----M--M-EE--oB--?M--B---?o---?-MM---oE?---EBE-B----BoEB-M-M-EM--oB---MBB-B-?-E-B--E-oo
-M---o?Mo-B-B-?--o-o-M-----?o??-MoE??-MM?-BM-?o-o?--M?EM--E-B?--B-BEMBBE------M-o-B?o-?-BB--B-M?Eo-o-?-E--ooE--BM--o?MB---B------EE--o-M---E--oM--o?-?-B--------o--?---?MMo?B-Boo-B----Mo--M--BM-Eo?--oo
oBM---oBE-E--o--o?--M?-B---o?-M--oB--B---BM-EMB--E-o--M---?--?--o-o-----?--M--?Eo--E?-E?-B-??-B-?B?--E-----??M-?-Eo-----?E-E-EBMB-?--B---M-??--B--?-B------?B-?-oM-?M?---?-oo--B-?oMo?-B--EM-MoMM--o--oo
---E-oB-?---M-MMMB?----o?B---?-?ooE---?--??--??B-M-o-E?oMooB--Eo-?Moo-B-BEM--ME?oM--o-??oM-EEBo??MMB----o-o-----o-?-M--o---B?Mo-----?--?---B--B-oo--M?-B--M-?o?-o-B-E-BEB---o-o-EM---o---E?B?-o--Mo?o-oo
?-----MBEMBo-----o--EE---M-BE-----M--BMMooo---M--E?-o---?----MM-----B-M-MMB--B--o-----o--?-M?---EBMMEB--B---?----o-o-----BM-EBEBMoo----?-B??M-B--M--B?MM--ME-??-?MM-?-o-M--oMMM-?-MMM-o-----??-B--oMM-oo
-EM?o--MMo-------MB?-M-B?o--M--?-?B---oE--o--B--M?----------o---Eoo?--o-ME?M--oB-o-oM--oB-E?-----B?---M----B----BB?-MMoo?--BM--M-----MM-o-M---BE-MoMB-?o-E--M-o?--oB-o-E-----?o-E-Bo----ME----?--EM---oo
--?o--??ME-ME-----?--B-??--M--BMMoo?-BB-?EM-?--M-MB-o--?--?M-BB?----E-BoMM--o?ooM-?--o?-o-B-B-oM-o---EB--BM--?E-?-?Bo--o-M-B-?M-B---E-?---?M--?BoE------?Bo--oB?---E-o-?E--M-E??--M-Mo---B-?o--E-BM--voo
--o-?M-B?BoBB--BME--o?MEM---MM-oEo?--BBBB--B-Mo-B-MBB-M----M?o-o-BooBo----o--oM-M---?M-MEM--EM--MB--?Boooo?o-BM---o-B--??-?BMBB-M-MoB-B-?-B---B-?-B?o-E--oM---??-?E-o-oM---o-?-o-MM-----?-oM-M-----E-foo
-M--?o--B--o-EM-M?E-MEM?BBM----E?-MoME-o--EoM-M--?--MoMoBM?o?oBoE?E-ME--o-BE-B----oBBo-MB-B-B--o---M??EB?-----EE-o?E-M-?-B--?-oM-M---o--EMB---o----??B-BB--MoEo---?M-ooo??B-o--ME-?E-??----------o--ofoo
??-oM-M---MM-?M--?B---o-EM----???M---Bo-o?M---B--?-E-B?o--?-M?M--B?o--??oBB-o----?-EBEo---MM---Bo--EEMB-??E-o-?Bo--?--M-oEoMo-M?-BEMB----MBo?-BM-?o--Bo-BE-M-ME-B---Booo?---MB-?-MBBM------M--o?----Efoo
M--Bo-oM-MB-E?M?ooo--BBE-B-oB--o?o-?-E-?o---Bo---M?M-----E-M-B-----o-Mo?o-TM---?-M-MMMo---?B--?-E----B-B-B--Eo--B?B?-Moo-B----M-----B--ooo?E--Mo-B---M-?-BM-?M?B-oM----M--?M-E-M-M-oEM-M-Eo-?-?-oMo-?foo
Eo--M--??---?-EEME??Boo-E?MEB-o--oEMM-?----B-----TMMME-MMBM--?BMME-B-?----|M-oEM----?MMEo-??-o?BM?---EBM-BoEB---oo-o--E-M-M?-------o?oo-----Bo-M?ME-?ME----??-B?T--E?MM?-o?-M---oEME-o-M-B---?MMooEEofoo
---?M-o-B-?EEoBBTB----BTMM------o-?-?MToME-B---?M|TE-M---o-EBB-MM?--?-BB-M|oTBTo-B-----MTTo-o-?--MBEEM----oM----E--TEB--T--MM??-oMB--BoEM?-BTTB-M-----BM-ETET--M|M--M-M-oT-B---o?--T?--------B??--?M-foo
m---Mo-MoE-M---o|?o?--E|oB-M--M?MB-B??|EM?-EM----||-o-?---?----MoBo-B-?--E|E|-|-??--BE--||-BEooEoB-???E--BM-EMEo-?E|--E-|Moo?M?EE-?--BEM-B?o||------BB-E-B|M|--E|--EoB?oB|---?E?-oo|EM-B?-?---E--?-oofoo
XXXXXXXXXXXXXXXXXXXXXXXXXXXXXXXXXXXXXXXXXXXXXXXXXXXXXXXXXXXXXXXXXXXXXXXXXXXXXXXXXXXXXXXXXXXXXXXXXXXXXXXXXXXXXXXXXXXXXXXXXXXXXXXXXXXXXXXXXXXXXXXXXXXXXXXXXXXXXXXXXXXXXXXXXXXXXXXXXXXXXXXXXXXXXXXXXXXXXfXX
