-EE-EE?MM-------o--?-o--?-ooM--BB---oB------oo-?--M---oEB-MMoo--E--?o----BoMMB-BE-??--o--?--------o--?o-MMBB?--ME-B???o-o-MB--EMMBo?B-M-BB---?BBB-B-B----?M?oME----E-----B-o----Bo-?o--B?M------?oo?--oo
oM--?---oooMo-?--?--------?E------oMMBoBB-M--ooBE---BBM----M-Mo-M--Mo---M-----B?--oo----?-Mo--o-B-B-o-MoBB-o--?oB-M-?--EM-BBM-B-?-M-M---E?-?E--BB?-Eo--?-----?M-M--?-oEE?MBM-o-B?--M-oEo?M?------M--M-oo
-?--?B-Eo?-B-oo--E?oEoB--EoM-?--MMB--o-M-?M?BME-----?-M---Eo??oB-M?----------BM-MB-oo-B--M----B--?o-oo--MBB-M---o--E--M-o---?M--M-E--EB?B-EMB-B-E-??-oMBo?--o?Bo-?M-o--B??---M-B?MB--MM?-MM--oM-o-B-?-oo
Eo-o-Mo-E-oBEE--?ME--o-----o--BE?-BMM--M-?B-?o-oo--B---MMM??MMoE--EB-?-M-M-EooB-oBMME-?-----?--ME-?M-Bo-?-oB-oo-B--?--o-M?oB-Boo-BM--B----M-o-M----o--BEEE?M-----------B?o--BB-o---o?-BB---BM-Boo--?o-oo
--B-??----B-B-?-?-?-o-?---??--B-MM-M-B--Boo?B----B--MoME--?o--o---??-ooMB-E?-o--?--o?MEM-EEBBEM-MBMB-o-M-MEoB?-??M--ooMoo-M---M--M-B-oMoE-Mo-BoM------?--M?M---M----oo---EBB--E-M-?-----oE--E??----o?-oo
-MB?oBE-?-?M-EB--?o---EE?---o-BM--?----E-BM-----EoE----?--E-?oo-ooB?EM----BMEoMoB----EMo-M-BMBB-B------??M-?M??--?Bo--M?-?-MMoMooBMB--o-?-oE-??M-M--oBo??-------o-BE-oM-o-?o??M--?-BB-EoM?------?o-M--oo
?M-Mo--E-?-M?MEo-?--o-BM----M-MBM?B---?B-o-E--MM??M--BM--MBM--Mo-ooMMoM?MM-oM??MMM---M-oM--M-?-M----oo-BME-oM-----?--MMMo?---???-o----EM-o-B-MM--?B-B?B----oM-B-?--B----oo--M?Mo--EE?-B--EM?MB?----oB-oo
---Moo??-B?--------M-oM---oB--M-EoB------B-?--oBM?o-M-Mo-oM?o---M-oB??-B--BEoE-MM-oo--BMM---B-?----M----o-?--MEo-o--M?M-M-?-?---oo-?o----ME-BM-?-----?M-M-B--BBo--M?E-BB-B-B----o----E?-M?EEB--?-EE-?voo
?---BM-?B?-EMM-oE--B-EM?o--?-M?oBoM--?---E-EB-----ooEo?oE---?B-o--BE---Eo--M---oEo--o----??B-E-Mo-oE---Mo-EB--M?-?-E---MM---?o?EMoM--o---?-B--M-B--o-MMB-MEoEo---?-MMo-BoBB?EB--?M?M-B----?Mo-M--?--Bfoo
-BE-E-ooM----??-BM--M-M--------?---M??B-o-E--B-?oBMo-B--Bo-o-Eo??o-------?--------MMoo--EMB-B?--B-BMo-o-MoM-----BE-?oo-M---oM-?BB---?BB----M?-o-?-?EBE--B-----M-BoE-E-?-M-E-?--BM-?-oBMME---?--oMoMo-foo
B-M??-o--E-----oMM?--B-o--?BoE-----MB?--?-B-M?-B-BooM-Bo--B?-B---E--B?oo-Mo---?E?o-o---E---MMM-?---EB?-B-B?-----M---E?BM?Eo?E-M-o---M---E?-BMo?--oM-M---?-M-B--M-o?MBMM-----BE?-?-EB--Bo-MEo-BM-M?-o-foo
B---o-ME--?--EMM-M---o-Bo-E---??-----B-E-EE-o--o-?-EB-B-?----B--E-oB--?--B--EBBB?---E--M??BoMo?oE-o--?o?-oB-?---?o--?--M--?E-o?Mo---?-----??-MM-B---?o-?E?---?--?EM?EMo-Bo--B--MoB---B-M-BME-EoB-?-o?foo
--B?ToE--o-o-B---M--MM-o--M-o?MB-?E---EB----oo-oM-?-B-o--?-?-oo--o-?B---B?E-M-E--M--M--EBM-?o-M--M-o-o?----?o-E-Bo-E-M--??-M-M--Eoo-----o--BM?ME--MM-oB--o-oB--ooB--?---?M?---Mo?M---?ooT--M--B-----Efoo
-TB-|----o-Mo?o--o--oB-o-MBB--BM----TTToT-B--E---Bo---------?--EMooEB---o----??-BE--E-M--o?MBBT-BT-B-B----B?oEMM?-MT-M?---BBM-?o---BTBoBEoM?-T-T--EM-?-E-BTME-----M?--E-M-E--M?T--?B-E-?|--BMoM--ME-Mfoo
m|?B|MM-MMB?--MMEo--B-oo-E-MB?E--?-o|||-|-?-oM?oM-??E--oB-oBM---E?o-M--?-EB--EM-M?M-BB--o-B-o-|Eo|M?MB-?EB-MMBM-E-o|B-M--E--oE-BEM--|-EB-EoB?|B|E-Boo--ME?|o--E-o-MEM?MBMo--E--|-Mo-o-?B|-??E--BBBMEofoo
XXXXXXXXXXXXXXXXXXXXXXXXXXXXXXXXXXXXXXXXXXXXXXXXXXXXXXXXXXXXXXXXXXXXXXXXXXXXXXXXXXXXXXXXXXXXXXXXXXXXXXXXXXXXXXXXXXXXXXXXXXXXXXXXXXXXXXXXXXXXXXXXXXXXXXXXXXXXXXXXXXXXXXXXXXXXXXXXXXXXXXXXXXXXXXXXXXXXXfXX
