M--Bo--M-oM-E?E--E---B----oBM---o-M-M?E-oBEMB-?-B-BooM?--?BoMoE-?M-oBB---oM?--MMo-M-o---E----o---B-oBM-oEo--oBo?---MB----B---B?MM--BBBB?-ooB?o-o-MoEo?o--B--BMo-o----?-?M-BM---M-MMoM-?BBo--MoBB??-Bo-oo
--??-o-B--M-M--EMB?-oo---Eo-----oMMM--?----?BEBM---M---o--o--B-B-o?o--E--B-----MMo---B-M-M-E?----B--?--?M--oo-?--M-oM--M-?-----B-B--M---------o----MMMoM-o---oEo-M--M-M-E--M------o-E-B-o??--BM---o-?-oo
M?MoM-o-E-E?---?B-M-MB-E?-B-o-ooEBM?-M--EoM--M-o-?E-?M-Eo--B-M-M??E?--B---?Bo--MEBE-M-o-ME---?B-MoMM?--EM---E-oM--?M-EB--M-?-Boo?B?BM-oM--o??Bo-B-------o----o--E-Eo-B-----?-o--ME-----B?-M--MBM--?oo-oo
--M--oE?-MMo?M---------MM-M---?-----B?-oBB-B-M--??ME?-o-M---E--?-?M--M--B---?--BMMB--M-BB?o---?M?Eo?-M--o--EB-o-E----?o-o?---oBo-oBBM--E-o---o--------o-MoBBoo?-B?---?-??M--?-?BMB?-EB---EE-oM-o--M-B-oo
BBB-M---M-M----oB--o-o----Mo-?MM-B--B-B-o-?-??o--B-B--?BE---Mo-?--M-----B-E-oEM-BB--o-Bo---?E-BEB--Eoo-o-?MBM---M------ooMMEE?------o---o-o--o---M-oo-?EMME-?--E----?-EE?-ooo?-?-MMoM--?M?B-M-M?o-o---oo
-o-M--------B-E----Bo-E--B----MoEB---B--M-----B-E---Mo-E-MM-?Eo----E-?-M--MB-MB--MM?--?-o-o-BMMB-EB--?---o-oE----o--o-MEoBMM-?BEEM--B??-BMB-?ME----MB--BMBB-Bo---?------B?-oMo-B---oB------oM---B-oo--oo
o?-B?-M-?----B--o-Bo--Bo--ME---MBB----MMM-B-Eo--M--M-M-B---?-BMM-E-B--E-------o-o--EMoM----?--EB-M-B---B--o?M-B--B?-M-M-BMBE-B--Bo-E--?BM------B-E---ooE-B?E-?-?-B-o--MB---BE--oB?M-----B--o-BBB-EMB?-oo
-o--MoB------B-M-E-M-B-E--?Mo---?---E--BoB---M--B?BM--B--o--o-E?--Mo-BMME-BooM-oo--M----M--?-M?--o---M-EM--------M---oMM-MEB------MB?M--?-o-------?--o------B-E-?--M----BE-EM---o--o--B--oM?M--EE----voo
----B-E--BE--o??--B-B--B---Bo--Eo-o?--o----E----Eo------?-B-MMBB---B-o--?----o?E--EBE---oB----M-E?EB-oEM?MEo----B--Eoo-B-?---o--M-M-oo--BM?o-----EB------M--?o?----B-M-M?BE---?E---B-o-MoM-M----B----foo
---B?o?-EM---o---?---?ME--o----B-oo-oE-E?BMMB-M--M---B---BB?--?---o--BE-o--EMo-B----B--M---------E-M----E-B-E-M-?M-?--E-o??B---?----MB?--B?-Eo--M--?-o-M-?EBo-M-EM--E-------BooB-BM?--oB?--M--BBM---Efoo
--B-E?MBME----M--M--B---o-oB?-?-----B------M--?-E-----o-B-----Bo-BooBMMEo---o-?--o-o-----?BE--?B-B?-oM--M--M-oB----M-BBEMM?-Bo-M-o?Boo-oE-E---ooo----Eo---M-M-?---o-M--B----o-?EMo?B-EBo----Bo-?o----foo
o-Bo--B--MoM-o??--??--B?-----?o-E---o?--B--o---o?B--?-oB?---B---BE?----?-oB--M----??oBo---o--B------EE---M-?-E----MM--M?--??---M-E?BMM-o?BM--o--?----M-M---E------M??-oE--o--M---?EE-?MMB---M--?o---ofoo
--EB?o?E???--ooM---?E----M-E----B-BE---BoB??ooMEoM-o--E--o--o-M?-Bo--M-BBM--B-M-BBo-???BB-o----o----?BMB-?--E---oo-BoB--B-?-?---?B-EBB---MEo---EEM-?-?----o?BB-o-M----MM?o--B--M-E---BoM-E--?ooo-o-M-foo
-B----B?--?-E---o-To---o-TT-MME--TB?oT??T?o-o-o?--o-ME---o---oM?oM-?--??----o----oB-?-o----T-o---B-E-oo---TTM---M--------TBEM-?Eo-o??---EBB-o-T??B-o-T-MT-TBo-TBT---Moo?E----oT-MBTTE?B-----?--?B-o-ofoo
m-B--M?BM?E-MB?MoM|-?-?o-||-?--?E|oEM|B-|-MMEEBBEo-BMBM--M-BMB-MMBBo?--E?oEB-Eo?oM-M-MM--EB|BE-?-EM?-?-?oE||-B--Eo---M--M|-MB--??MoBMoBE--?---|?-oo--|-?|-|?-o|E|EB-M?MoBBo--o|E-B||B?oM?-BM-B-B?ooMEfoo
XXXXXXXXXXXXXXXXXXXXXXXXXXXXXXXXXXXXXXXXXXXXXXXXXXXXXXXXXXXXXXXXXXXXXXXXXXXXXXXXXXXXXXXXXXXXXXXXXXXXXXXXXXXXXXXXXXXXXXXXXXXXXXXXXXXXXXXXXXXXXXXXXXXXXXXXXXXXXXXXXXXXXXXXXXXXXXXXXXXXXXXXXXXXXXXXXXXXXfXX
