M----BB--?MEM-?o-M-E-?E--oo----o-MBB-BB-M-oB-o---E--o??oB--M-EM-o-?----?----BoE-B--?---M-----oBM----BB-?M--B--oM-oE-E--Moo--?M?----BE-?o?--?--B---?-B-o-oo---B---E-BM?o-MB-B-----MB--M-B-----?M?---EMM-?
-B?-M?oMMB?-o---BE-B--?--?-B---B?EoE---MB-B??-o---B---?M?o---M---BB-BEM-o--B--M----E?--B--Eo?o--M-o-BM---?Bo-o-----BBE-BMBE--M---o--B-?oM--o?---BMBBB-o-oEB-EooMBMBoo-MM---Mo-----M-?oB---MB--?-oo--BE-E
-MoM---o-?B?-o?B-M?-?oMo--EB??-B?M-BM--?E--B-E-o---BBoM-?oM----Bo-?--?--o----?M?-Bo-------BBB--ME-Bo----MM--Eo-oMB?BM?-?-?----oB----oE--M-o-E--BBE?-BB---B--?-B-o----B-M---B----o-o?-?-M---BM?-B--B?M-o-
-oBM?-----?--BBo--?---MB-o-M?-B--EBo--?M?M-M---B-??oBM--M?B-B-M?--?oEM?B---MM--?B---M--o?---B---Mo?E?-o--oMBBMM-M-EBMoEoMM-E-oo---E--M---B-o-oB-MMoMM?ooEoE-B--oM-o-M-Mo-E--E-?------E--MB-oE---E-o-MBBB
-M--MMB-----MM-M--B-oBEMBoo-----?-B?-B--M----Mo?-oB?-??--BM??BoEME-M--?B----o-oB-BM-oE-E--M?o?--E--M--EEEB-?BoB?-oM--B-o-o--o?---o---?--------o--o------?-B--o-?B--o?o-o-ME--oEB--o?o--?o?E----BB----M-B
-o--M---M--o--E-?-?B?BM?o?E---o-ooM---B--B--o-M--?oEE------??-o--M--MEB-o-----EB?oBo----B?-----M--?oE-M-B?MB-??-o---E-?oB-o-ME-----EEMM-----M--MEoEoMB-B-M-B??-o---EB-B--M?BoBB-BBEo-oMM----------BEo?--
EM--?---o-M-ME?--E-MEMBE?B-M-EM--BBoB-ME?BE---MMoBM?B-E?-o?-M---o-BEoM-E-B-?o?B-o-?-M-E---BB-E-MM?--?-?E--oM---o-----B-o-o-o?M-BMB?--?Mo---B?--BB-B-?----B------E--MEMMM?-B?-ME--?-?--o?---?-?E--ME-?o-?
---oEoM-?E-?---E--oB--?MM--?-Bo?BM?-?--?-?--oB-oo-oM?-MMM-MB-M-E-----------BMB-??M-?-BB-EEB-B-M?o-M---EB??M--B-B?oE---BM?------M--Bo-?-MMoB----oMM-MB?B?E--o-MEo?-o--BBoM-?-BMBM-?---oE--?-oM---o--?B--v
-M--?MBM?--M-o-M-------B-B--?oBE?o?--B--BB-?--oMEE?----BB?EE-Bo?-B---EE-Moo--M?o--o-E-o-BM------BM-E?M-B-B-o-M---o-?--------o--o?oBB---E-B--M-?-----M-oMBB--EM-o---o---oo-B-oBE-E-MB---M-?-BM--?B-ooBM--
BB-?--E-----o---M--o---EBMoM-E-B-BEM--EM-?-oBM-BMM-M-M-M-B?M-?M?--oBE-M-E-ooo-B-?o--B---oB--o-M-EM---o-Mo-?M-M-BEE-BoMMB--?-?B-E-Eo----?---MB?-M?-M--B-M?----M-MoBB--?-BB-oE-?-E?o--?-EMoM--BoM-M-ME-?BM
B-M?BBM-B--o----E--oEBE-E-oo??-BM-?-?-Mo--?-?--oMMBB-----M-?-oE-E?-MMM-E---B----Mo-o--o-?B-oo?-BM-??ME-M-?BE--?-B?---??-BoM-?o----o??-?BMo?M--?----M-B--BB--M--??oo??M-o-?M-M-?M-oo-M--B-E--M--o----MB--
---?--oM--B-MB---B---?--Bo--?----M?o---?--?-o-B?--B---?---oB-M--?BEMo---B-B?B--?--?o-o---o-E-?M?o---?Mo?---M-E--MEMB-o---?--B--?M-B-oBEB-oM---Bo-MM--o--oBM---BB???-M-?-MEEM-M---o-----EMM-----oo----B--
------BB-MMM-Eo-BoM?E-o-EMBBM?-oMBB-oB?-BE?--B-?M-EME--M---?----E----M------B-BM-?MM--TB-M-M?B------B--o?o-?-M-E-?--Eoo-?-E?-?-------M?ME--M-M-?--B-MoEB---o--EoMB?-Mo---BM-ME?--BM----MM--EEB-?-BTE--EE
Mo--?-?M?MEME-EEE--??-E-M--oB-M-?--T-MoB-T---T?EoBB-MEMT?--M-o-MBBMo?T--TTM?oTo----M-B|MMBT-EM----?T-ooEE-EB-o--MTo-?M--oMM-B-o-E-BE?TM-T----MMo-?E-o?MB--T?-E-T?-oT-----ToEE---MTT-oo-T-ToBB-?o-E|BB---
m-EE--Eo?-BBMEM-MEEMBo?EB--B?-B-BEM|EM??o|M?o|M-??--E??|-o--M-o-B?MMB|oM||---|-EE--EBB|-?-|--BE---M|-E--B-MM---B-|oM?o??-?M??Mo--o---|M-|EE-?o-BoM?o--?-oM|E-B?|ME-|E-o?o|oBME--E||--?B|B|-?E????M|??oo-
XXXXXXXXXXXXXXXXXXXXXXXXXXXXXXXXXXXXXXXXXXXXXXXXXXXXXXXXXXXXXXXXXXXXXXXXXXXXXXXXXXXXXXXXXXXXXXXXXXXXXXXXXXXXXXXXXXXXXXXXXXXXXXXXXXXXXXXXXXXXXXXXXXXXXXXXXXXXXXXXXXXXXXXXXXXXXXXXXXXXXXXXXXXXXXXXXXXXXXXX
