-ooB?MM?-MBM-BB?-o-----BM-----------BM?-BB--E?B--?oB--B-MBoMBM---B??E-???-BMo-?--M-BB-?M-B-Eo-----BB?MoB-MB--o-oM--M-B-E?--MMB?????-ooo-E--?-o?E-M-B---B-BEM-?B?-Bo-BB---o-BBBBM--E-B--o----B--M?---?-oo
--o?BEB?E--Mo---B--E-?Mo-oEo-o-oo---o-?-----B--?o-?MBME-?E-?-M-----B-o?B--o--??o----?oo-------BE---Mo---B-?-?E--?M--?-?B--?E-?-oM-BMME-??M---?E--E--?o-------?M---BBB-B?M----E-?BBBoBEoM?EEM-----oB-o-oo
--?---BBB?oBo-?-M-E-E?BE-MB----B---EB?-M--Bo-o--MM-M--MMo-----B?M---B-o---ooM--o--o?M-E--M-----B-o----B?--o-?---MBBo-oBB-MoB-E--Eo--B---B--B-M-o-?oE----M----B-B?----BB?-EB--?o-?-??-?-Mo-M--E--BB--o-oo
--?----MBoB-E-o-?--EB?E--B-?-o--M--??--Eoo-BMoE------o?MM--??---B-M--o---Bo---BB?E-oM-B---o--M?oM------B-o-oo---B---?---B---------ooo--o--ooE-----?B-M--M-M--o?B-B?----B-M?oEM?--o-o---EMBMEB-o-B?oM?-oo
-?EBo--E-?-??MM-?---B-BBM-?M--ME?oM?-?B-E?M---M?-------M-MoB--E-?-BMB-?oE?-?-?MM-MMoo------o--MBB-Bo--?--?B----?ooM-?-B-----o----E-MBo-M-Bo-MB------EMB-----M-----oo---EBBMB?M--o-M--M-M?MBM-E?---B---oo
oo--oM-B-?--?--EoE??o-M?-?B?o-B-o-B?oB-o--oE---B-?--?BBE--MM--M-?oM?-B-EM-M??oo--BMM---BM?o--BM??-M?-?BM-B--EBo-M---M-Mo--Eo-?--MBE-M?EoBMB--???----B--MM-o-Bo-oM?BB--o-?-??o--oMoB--?B-o-MM------?EE-oo
Mo-B-B?BoB-E--M---o--BEM-?M-------MME---o-???-?---M-B??B?-oB-o-Eo----oE-EBoM-oo-B---oMoBo?-??B-----oooE----EB?M-MEBo-M?MoB--?BB---B----EMBBoo-E??E-M--MEEM?MM-----oBB-----EB-?Mo--?-?BM-B-?---B-?-o---oo
?M-o--E----?------?oMo-o?-o--M?-o-?-M----?M--BoB---M--o---EE?B-MBM------BM?MB-o--o---o--MM?--Eo-BBEM-E------B---B--?--?-M?--?---B--EB--?-??-B-B--BMB---MM--B-?---oo?M---M-B-Eoo---EE-oo-M-??oE---E-M-voo
-E?EoBBEo--?o-E-BBo??-?o?-?o---o---B-?-BE---Bo?E-oBM-M-Eoo---??-oE?EB-??-?B--o--------B?Mo---?-------?----o---Eo-?-M?--B-M-?--MBM-M-?MM--M-----o---BooEEE-------M-?-oME--B--B?--?B??o-?o-EMo-?-o-?-B-foo
?M-BE--?M-?M?M---EM---oBE-BBE?o---Bo-o-o?-----o-B----o----MoB--?-?o-M-EMo?B---M------oE-----?-EMo?Mo-B----o-M-BMM------EoMMoMBB-M--oM?MoE-?BE-B----oBM?-M-?E--o-o--M---?BBoB-----BE--EE?----EB-BE-M?Mfoo
--o-?-?E----B--B??-----M?--M-?--BE--B-E-Mo-M-M?-o?oB-Mo-o-o---oMB-o-B--o--E-?-EoE--MM-MM-Mo-?-B-oMo--M-oo----o-?-M?BE-o----Mo?-B----oMo--B-E?-o-M-M----o-BE-B-o-oB-M?-MM-?oMoBM---?--??B-oo-?------?-foo
MBE----B---M----?M-BoEE-oo-M---M-B-oMEM-o-o--oMo--?----BMEMBB-E-M??BB-oM--?M-BBoB?B--B-E?-B-?--M--?--oo-------o-----?--EE----B------o-B-oB?---o--?-EEo-?-?-EBo--M-M-?-o-M-T---o--oo-M--BM-E?o?-?o--o?foo
o??-B-??--B---B-o--Mo?------o-o--B--o?B-o-E-M----B-ME?---?B--EMo-E-T-M?--o--?--M--?T-?o-TBo-B-E--E-o-EE--?---?E?oo----?BM--EEo-Mo--o?B?-B?-E-?EE----M?-----?----BEBM---MB-|--MMBB-MMM-?---B--o----?--foo
?--T?oToEo-B-o--oT-M?oM--E-MBB-Eo--T?-?E---T??--Moo-T?TBEB??B---oMo|M--M-?--o-?-o-M|-??o|T??--ooB-M--B?M--o?BE?---M-ooBMB---?---MMET--?-oTT?--T-oT-B-M-ME-MBMT?M-ToT-E?-Mo|?B-o-B---T-o-??B?TM-------foo
mM-|M?|o?---EoE?B|?-B?E-EMM----?ME?|MoB--MM|--oM-BE-|?|E-B?-?oEBBEE|Eo-----BB--E?--|?--M||--Eo--E----?EB--?-BBBM-M-E?-MEEB--oE--M-B|-M-E-||-BM|?-|-B?--?M-oE?|E-o|?|-?MMB?|o-B--EM-E|-o-E?MB|oo---?-ofoo
X----------------------------------------------------------------------------------------------------------------------------------------------------------------------------------------------------fXX
