-oo-----oE-??--M-Bo-BMM-M-oM-EMBE-Mo?-M---?-oB?M?o?---oE-oB--B---?-B--?-??MB---B-M-?----MBo-?--?---Moo-o---E?-E-BB----oE--o---oB-o--M-M----M?-----M-BoM-??M---MoB----B-?-Eo?o--B--o-M--B------B-E-MMB-oo
---EB-B-MMo-----?-M-MBB-B--oo-o--??-BBM?--E--B-?---B-E-M-BBM--o----B-MB-?-oME-o-B--M--B-B-MMoEM-MoM---E-M-??E-B-M-----oB--o-----E-BB?-?BE--?-B-oE---oMEM--MEoo-M--?M--oE-?-E-?E-E-M??--oMo?---o--o----oo
--?BoM?o?-?--o--M--MEo---o-?o-?---MB----B-B--Bo-Mo-?-M-o--oB-?oM?-?BBo-?-M?-?-o--o--M-B-M-oBM???--Bo?BMo-?-oM?---MME--M----?o--?M--o-?--?o-M--M-B-?oMEMo??M?B-Mo-E?-?-B?-M-?B?-MB--M??--o-MMoB-MM-----oo
-BoM--EE-oM-B----o-MB--o-M--Mo--M---?MM--B--??oEB--o---Mo---o-M-oE--o-?-Mo?-ooE-E-----oEM?---B?----o-MM?M---?M-??---M----?-oBME--o-oBo-oMM-ooE-BB-ooBB-----MB--o??--BB-EEoB?--o--------?-M---M-MEB----oo
-B-o-o---?M?-------B-MEM-?o?-?B-??-B??---M-M?B-B---M--o----Mo-oM??BBo-o---M---BEB?--oM-?----E-o-o--EE-B?M-M??BE---EM--oM-?oEo-M--?--B-MMMoE?-B-B-MM-Bo-ooMBB?oB--MME-?E?B-ooBBBM---M?--E--M-?---?o?B--oo
B?Bo--?-M---M-MMMB-?E-M---MB----E----B--?B-o-M---MM---oE?B-M---M-M-B-o----o-M--MB-E?oE-Bo-B-BM-o?-B?Mo-?B--?o?M-M---Eo?o-oM?M---M--Mo-Bo?----M--MoM-B-B-?o---o--oM-----B-o--o?M----Booo------M---BBo--oo
MB-M-----B??BMoM-BBo-o-BM--o--oo-MoM?MoM-?---M-M?oo--BBBE--B-E-EBMB?-----M-BoMBo-B?--?--o--o--?Bo---Boo-oo--o---?EMBB-MEE-?ME-M----M--EBMMM--?-Mo-??--------E--E-M----M??--B--?---o??---?BB--EB?MM-EM-oo
BEMo-M-BM---BM--M----?-?---o---MM-MBo--oo-?E-Eo-M-?B-------?BBEM--BM---MM?oB-oM--o-oMoEoMo----?B-oo-B?E-oo-ME-M----o-E--?-oB---B?B-oEo-oo---oM--EB?Eo-M-----B-----EB--E---M-----M-BB-E-M-BB-BM?E--o-Bvoo
M?----?-???M--M-MM---BoB--o--o-?o?E-o-oMEoo?--oE-o-----o?--??BM-B-oo?M-M---oE-?B--M---?B-?--BB?BoB?-o-----M-MB-o--BoBBE---M-E-EMB?B--?----?E----B--MM--M---?--??-----M-MEo-M-oo?Eo-B-B-E------EBo-B?ofoo
Booo-o-MM--oE-M------B---o?------o?-B---B--?o??-?-?o?-?---??Eo---MooB----MB?--oo-o-Mo-M-BB-Eo-EEMMEMM-E--ooM-o-EB-??B-BE-M----M-?M-Eo---------B-o--B--M-MM--Eo---oBEB?-?-----??----B------?--?M---EB-foo
?B---------?--BM-oEMMM-BMBo--E-EooM?-?-E-Mo-B----oBoBBE?oB---M??-?-MB--EM--EM----MoE-------??o-MM--B---??-?-?M--M-??M--M?-----?--E-?E-M-M-E-o-?-?-MM--BEB-MEBo--B---ME---Eoo-----o-Eo--?o----M--M-M-ofoo
M--???B-o-oEoo-EBBMBMEB?-E-M-BE-B?o-o----BMo---E?Mo-E-B?Bo--o-BBo?M?M--??E-M--MM--M----?---M-BMB-M?--E?BEBo--Mo-B-oM-o--E----MEMTM-??--o---B-o-o--oooo-M---M-------o----BM-B?-B-o----o-oo--B----?--B-foo
-oM-E----?-?MB--o---?-----E-?M-B?B--M----M----BM?---?E-??o?oB--o--M--BM-EMo---B--oMM---BEBoMo--oM--?-M--B?TB-E-oME--------B?-B?-|-MB----MM-o----B--------?--E--M-EM-M---?To-oM-oT-Bo--?M---M-M--MBE-Mfoo
?T-EBETE-ME-----oo?-TT---EB?B--?T-E-B---M-??---TMT-oB-----BM-To?oo-oo-M?M---T-Eo--?TB--E--BM?--M-o-----o-B|-M?-BTM?-o-M-T-B--E?-|B-----E--o?Bo-BE--MMMBEE?o?-B???-M---EE-|o---?M|MoMM?B-oToo-o-oT??--foo
m|-M??|M--?---BE---o||MoEMM-EMMo|?-E--??-oM--?-|-|EB???---B??|-BoMBoMo-oE--o|?M--??|-M-??BB??BoB-o-EBM---o|EE?BE|EM--MEB|E-ME-MB|-BBBMoM--E-Bo-E-oE--E?----o-EEB-o----?BB|M-E-?M|?--M?ooB|M?EBo-|oEB-foo
XXXXXXXXXXXXXXXXXXXXXXXXXXXXXXXXXXXXXXXXXXXXXXXXXXXXXXXXXXXXXXXXXXXXXXXXXXXXXXXXXXXXXXXXXXXXXXXXXXXXXXXXXXXXXXXXXXXXXXXXXXXXXXXXXXXXXXXXXXXXXXXXXXXXXXXXXXXXXXXXXXXXXXXXXXXXXXXXXXXXXXXXXXXXXXXXXXXXXfXX
