o?-EM?-B---MBo-E--MBB--M-Mo--M---E---?---oB?-oBEoE-E----oM-?B---E?-B-oMoooB-MB--M---?B--o-E??o-M--M-B-?-o?M?o-E--M?B----M?-B---o?--?----oB?MoB?oB--EoE-o-BEo-?o-BMo-E---?---o-M-EM-----o--?--E--Bo--M-oo
---MEo?o-ooB--M-E-B-EEBBMM-EMB-oMM-BM?--E-?----M-BMM-?BM--E---o-M-B-B---o--M?MMBo--o--BEME-MBo-MM----B?--?-oBMM?-o--o--BE-o-B-B--------oB???-EE--?-MB-??o-B-M-oB-BooMM----?M?-M?M-Moo--M-?oEE-?MB--M--oo
MM-MB-?ME-B---?-----MM---B?MB--B??oo-B--BEBoB---BoB-??M?B-M-E-M?E-EoM--BM-M?-E-oE-o---B??-oB----MB-E-E--o--M---Mo-Bo---BM-M-M?Mo-MB------?oo?MMB-?-B---B-B?M-B---?--oM-Eo-Mo-EMo-?E---?-?--MBooE-??MM-oo
B--M--E---B--E-o-M------o?-M?o-oM---?M?-?-?B-?o---B-oB-?-?oMM--oM-??-MM?-Bo-o?-E-?oo-?M-?o--M-MB-?B--B??--M--?---o-?B--?M-MM-?M-M-EB-o--M?-?-?--M--B?M-E---BBBB-oM---BB?-Bo--?-M-E?-B?E-EM---M-B??M---oo
Eo?--E--BEM-E-MoM-o--E?M?--Eo--M-BB------?-M-o-M--oo--MMo--?E---?---E?B-oB-o----EE?EBo-EBMBo-M??MB-?EM?MooMB-------B--oMM-?E-?-?E-B--o----EBBB-B-o-?M-B-?-M-?-B?oB--BM?Bo-M---ooMM-o-B-------BMBB?-M--oo
--o?---BBMBoBBM?---oE---BMEMM--?EM??o--?--M?--ME?-o--M--o-o--oMo---BB-?-M-??-E---B-Mo-?M---Eoo?M---M-?B-MM-MBoM---o--?--B-----o--EEBE--o-MBoo---ooE--MM?B-M-B--B-M--EM----o-oMo----ME?--B-B-??-?---B--oo
o------o?E---?-B-o-BM----??-??---?-M----E-?-E-BM-?o-o?-MBo-Bo-MB---o--M-?-B--M?-B?-o?M?-MB-B??--B--oo-E-o-EM----B--o?o?E--B--E-?--B?B-BMM--M-M----B--M----M-MBME---oMoE-E---?M---B--??-BBE?--o?M------oo
ooMM-o-M???-o-B-o?--?oMo??-MM--oB-B-Bo--BM--?---Bo------?---o--?o---Mo-?--oBo-o?oM----??-Eo-----E-BE-?-oMB??-o---B-MM--Moo--E??B-oMo-Bo?B-B--EMoo-?---E?BM-B--E?-E---B?---BEE-BEo-o--M?o---?o----E---voo
??-E?BM-Bo?ooME-MB-oMoBEBM-B-?-M-M--?E---o--B----?o--M--Mo---o--B----M-?BBo-??M-----???--B?B---?----?MB--EMB??-?--M-BE?-----B-o--o--Mo---Eo--?---BB----ooM---??oM?E--M-BME-B-B-?---?o---MM-M-M?M-B--Mfoo
?-B-B-MBM-B----EE??BB--?M----o?--MME-M-ooM-EMB--B-------------M-BoMBEM-Mo---BBB-M--EBM--E-B---EB-BMB--M?----B?---?-EoM-?-M-o--B--M?E---oo---B------B-o--M--E--oEB-M-----B?-oME---B-Mo-?-----BBE?o-MEofoo
-M-o?-M?M---MM?-M--B--?--M-ooE?B--?MEM-----?M-M--o--MBo-??M--o--???M-Bo-B?--o-?BoE-M----BM?---?-?E-E-oBoM?--ME?--?---MM-E-E-E-E-o-MB-?B-B--B-o---M?--MBoo----?--oo-BE-------B?--EBE-?-Mo--MM--M-B---Bfoo
--E?M---E-oEM-Moo---o----o?--M-----M--MBBE?M--?B??------------?MoE?MB-?oB--?-Eo---B-E----B-?---?B-B-------M--?B------??E-oM-B?B-MM-MB-B-M-B?-M-o--o--M---B----?B----BE---?-?---B?--B-M--o?Eo--o--M?M-foo
--MMME--M-BB---EMo?-MBM--E-MBE------?-MM-------MBB--o-B-oM-E-o-Mo----o-?-?o-M-M-o--o?Bo-?--oM-----B--B--B--BEM?--E-BBB--B----oM--?-?M--MB-------E?-Mo---BMoBM-Bo?oB-E-M-B-oo-o-BT?MMB-o---B--o-M----ofoo
-?-T-M?Bo?---oM-o-MT-E---MM--To-T-?-?--?-MT?-B-M--M-?B??TT-M-E--M?ETTM?-B-o-MEEB--ooM-B--ETB-?-o--E-M--?o-o-BTM?TT?-?EM-------?BMEME-?E----??ooB-To-?M-----oT-MT--B?T-?ooMT?---M|-?--B?-oMT---MM-?---foo
m??|E?B---EoMB-oM?-|B-o?E-E-B|--|E?-?EE-?-|M?--MB--?oBE-||Bo--?EM--||-Eo?M--?--o--?--oM-E-|M--EE?-MoMMEE-EB--|oE||M?-Moo-MEEMoB?M?-M-M-oo-Eo--MB?|oE-EM--E?-|-?|-Bo?|-?M--|-ooM-|?EEMBBo-?|?E-?-MoE--foo
XXXXXXXXXXXXXXXXXXXXXXXXXXXXXXXXXXXXXXXXXXXXXXXXXXXXXXXXXXXXXXXXXXXXXXXXXXXXXXXXXXXXXXXXXXXXXXXXXXXXXXXXXXXXXXXXXXXXXXXXXXXXXXXXXXXXXXXXXXXXXXXXXXXXXXXXXXXXXXXXXXXXXXXXXXXXXXXXXXXXXXXXXXXXXXXXXXXXXfXX
