-MB-B?B-E?BMo---?----o--M-E?--o-Mo-MMM----M---M?-M-?-M--MB-o-------???-?---M---?B-------M----?--ooBM-BB--?--M?-o?-??E-B-o----?-o?B-MBM-B-M--E-?-EEE---Mo--?--E-EB-MB--o-M-M----BoMMoB?--M---E--?EBEE--oo
---M-B-E-o--ooM--o-o---?--B-ooMME-oo-o--E-o-B--o?--M-oo---EM-oE-????oM---B-E--E--?E-?-M-?o-----MBM---oBBM--o-?Eo--oM?-BE--Bo-BBE-o?-?MB?--o--o?M-?M-?B----BBoM-M-?MMo-----?oE--?M-MM-----B-EB?E-Bo-M--oo
?-B-BB??-o----?M-oM---MoE-o-E--o-M-?--MMMo-BB---MB-M-MM?-----?B-M?B--BB-E---E--B-E---o-oo?M-o?B-EB---o?--?E--MM---o?BMM-o-B--??Mo-Mo--M----??-E-B?---M--?-BMoEo?o-----?--oM-?----B-M-o?--B-M?-?---Bo--oo
-?o---?o-EBMBMM-E?-M--?MM-M--Eo?-BBBMEM-oM--o-?-o---?--?-B?-EM----o?B--EM-Bo--M?-?M?--MBM--o---M--ME-Boo--BBM---E-o?-?ME-o--?MBE-M?-oMM-----o-BM-B--E-M--BM?-?-BB-?Bo-?--M----o-?-?M?-MMooB??-o---ooo-oo
BBMBM---E----BEBME-M---B-MMoB--BoE?-B---E?o--E-B----EME-o-?-MBBo--oEM--BE-o--B--o-EM----o---???--?o-oBEB----Bo?-B--B----oM-oMMB---M--ooooE-----o--?o-M--oMo-B---?---B?o-?--MB-?MM-o----M?M?--?MM-o?o--oo
------M----M-M-B-BEE?oo---Mo---E-B--?---BEoE-M-EB--M--MooM-Bo--oB--M--EMM-E---?--B---?-oB-?B---M-B-o-oMM-oEB--B-oMB---oEEMo----oM--M-E-M-?E-B-Eo-----o--B------Mo----M-?B--Bo-o---Bo--?---M----M-B?---oo
--o-EoM-?-?B-oM----Mo--E---M-M--oB-MM-o----MMM-B?-?BMoE--oBoBMBB-oM-oE-?B?-o-EoB---M----B------?B-MB?o--??-E?-o--o-BMoMB--BBM?o-E?-M---B--M-?--o-o---?oM--Mo---?---B-?M-MMo-----o-oE?--o------?B?-B?--oo
--MMB--oEo-E------o-B---o-B-MBM?M-B-----EB-?o-ooB--??--oMBB-B??---o--?--?------M--oB---M---E-o?E-MBMo----oB-Mo--Mo-M-E-o-oB----------B-?--MoEoB-?--o--M-oEEBM?-B-M?B----?-B-----o-MM-?--o-Bo--o----M-voo
MB-M--Mo?--?-B-EMB?E---?-Mo---M---?B--E-?--?-oo--B?--B----??oEBM-?-B?-o--Bo-o-M?---E?oB---MM-MBBMM-?--?-Bo--Mo-o-M-----oBMMo-?-MMo--o-MM--B-MM?oE--o?----M----BM-E--M-MBM?--M-B--?------?o------o-o-?foo
?BB?-BoB-?-o---M?B---B?Eo-MBBM---o----B-ME--oo-BB----?o-----o-B-E?o?--BM--BMM-M--?oBoE--M?o-MB?-B---B-----?-o-?B-oME-M--B??-M--o--?E-M--?-o-o-B---MB-MM-oB?--MMB-?-?BM---Eo---MM----M-B-?ME-----E-o--foo
-BoM-M-?oM----MB?E--oBE--B-MB--?------?oB-E--o---o---?BME-?-M--o---B-E-?o-Bo?E-M-B?-?-M----M--BB----MB----oEBo??-B-B-o?ME----o----M--?BB--?-----MoEooMM-?BoE--M--o?-oM-?E?EB-?---ME-oB-M-M?-?EoMMo?Bofoo
?--?BM-Bo--MM---MB-oMoM--BE---o--o--EM-?E-MMMMo--BB-E---?MMo-?M-B----MoM--B-oMo-M-?--?--B-?o--??-oMoB----oE--B--EBM?-o-B--o-o--M-E-Bo-o?E?M-?---B-BM-B-MBBM-oB---?-?E---MMM---B---B----?-o---ME--Eo?ofoo
--oBoB-o----?------E-----?--E?-oM--BB-----M-?-o-o-B-?--BBo--T--o-M-oB-o----TMoM-?BB--M-EB?--E-M---?-----o?-M-??M-BBM-?---E?-B-?----?o-BE-oM-B-MMBE?-M?-?E-o-B---?--MM?-E--------BMoMT?MB-?-o--M---M--foo
-?-TM-oBE-T-BB--oToM-o--E--ETT-M-B--B---T-M-BTMoTT??--?TBMTB|-TEMoBBoM---Mo|o-To-E--o?---BM-MTE-o-?--?BMM---T-BBB-?-o?--o--?T-MBT-oB-?-BB-M-o--B?M?TTMM-B-E----E--oBET-?TMM-BM--?---|T--M?--M---EE?E-foo
mBM|?E----|-ooE?-|-MM-E-B-BB||--oBoBo--o|ooBM|E?||EE---|EB|-|E|B--?---?--M?|??|----?BoEo?---M|?o?-B?-oB--M--|?B??EMoB-BE-M--|-ME|o-E??B--B?o-MBM--?||ooBE--E--M--M--B|Eo|---oM--EEMB||o--oE??--MM--Bofoo
XXXXXXXXXXXXXXXXXXXXXXXXXXXXXXXXXXXXXXXXXXXXXXXXXXXXXXXXXXXXXXXXXXXXXXXXXXXXXXXXXXXXXXXXXXXXXXXXXXXXXXXXXXXXXXXXXXXXXXXXXXXXXXXXXXXXXXXXXXXXXXXXXXXXXXXXXXXXXXXXXXXXXXXXXXXXXXXXXXXXXXXXXXXXXXXXXXXXXfXX
