---M--o--o--Mo-MMB--MM--o-o-oo---oE---E?MMo?-?Eo-BEBM--Mo-MEB-Bo?--E---?Mo-MB----M--B---?-B--MM?o----B?-?oE?o?E-?M-?o-M?E?-B?-oBE?-B??-?-?--?---o-M-?E?o-M-B?--?MB----o--oo-BMooB--Bo?MMMM--------E-B-oo
MMEoM--ooM?-----B--E?BB-M-----M-o-BE-MB-oM--B----B--BoE-Moo-M-BB----M--?---B-?M--MB--Eo-B-?--MMB---E-?----B--EB----o---B?o-oB-----o-M-?--BM-ooM-M-Eo-B?B---ooM--Eo--B-o-M----oM-B?oB--E-o-BoBoB-?-BM--oo
----M-M?----E-------o-----oMBo-E--?-M--?-E-BM-Bo---oE-M--o-M--MEo?--M-ooB---o--BM-o--B-??-B----E--?B-o--ME?-EBB------E--B-?--?o--oE----oEo--B-B--oBMo-E---?BB?--M----B-?-----B-o-BBoB----?ooo?--?-----oo
Bo-?o-o---B-BEE--o-Eo-E-BM-MM?-BBB--B-M-MM------BM-M-B--?---oMBBB-B---MMBEB--Mo---oo--?M-o---M?M--E--M--?MBBM?-?-E?-oM-?M?MoME?-MEBo-E?-BB---E-----BBo--M-?M-M--?--o---BooE-o-?o--B-o----BB-M???-EoEo-oo
?Mo??MoB--?---?oMM?BoB----BM--BM-BE?-o-M---?M--B--o?--o--B---o-B--B-E?B--M?B-B--oo-M-BoEEoBM---EE-?E--?M--M-?---?M-MBE-B-M?---?---?Mo?MoM-Mo?-----E?-?-B-?-E----M?-B-oBo--?BB-?-EoB-o----o--B--?MB-M--oo
o--ME?-B-oE--??--?B--oB?--M?--------?-BM?Bo-?---?BB?EoEEE-o-------o--?----E-M---?-----?--------??M----??-oMo?E---BM-??E?-M-o?MooM-----B---?-??EM-oM-Bo?M--B---M--B-M-o----B-M-M-MoMo-----BMB-----M?BE-oo
-B----M?-?MBE----E----oB-oB?E-o-oB-MEM---BM--M--E-BB--??-o?B-?-M---M?MM---Bo---?---BB--B-ME-oE---?-o--E---?--BoE-MB-----M-?-?--o?B--B?----??-o-?-B?--M-M-EE?--ME--?--B?BB?-o----B---o?B-MM--o---o-?E--oo
-?ooM?B---MBM----M-?MM-oE?---oMo-EoMBB?oMM--ooEEB-?--MBo-o-MMM--B----BB-BE-----?-B-M-?-E-M?M?----?-Eo-----B-M--MBBEooM-M-?BEM-Bo--E-BEB--Eo??BMoE-MM-M-B--?BME-MM-BB-oMM---M---?B--oM?---o-------o---voo
--oo--B-B-Eo-o---M-B---M-oB?--o-M-MB-o---o-M-B-BMB--B--E-MB-oE?o-B---E-EoBo-M-o----E--?--M-o-M-B-?oMM-?-MMoBMo-B-----M??o-M??M?-M---oB--o-----?o-----B-M-M--MM---EBMEB--o-MEEoBEBMo?----M-----o?M-?B-foo
--M-o-M----MMooB---?---M-M-o??-?--oo-?-Eo---E--BM-oo-E?--o----B---M-E-MB-----B?-M--?-M-o---?-BB--o-oo--B?-MB-M-MMM-B-MMEB--B?--o-?-o-B-MM?-?---o-B---?MB--oMM-B-M???M?E--E---oB-Bo--?-M-oM?MM--------foo
M-oEMM----Bo-?oM-oE?M---MoB-o---E-o-o-?-o-B-M---M-E-o-?B?--BB?M-E-o--M-?-B-E-B-M--o-M--o----B-BB?M----?-M-B---o-MoEMBM--ooo-?----B-ooE--o--M---BE-MB-MMM-??-B---o-B--M--M?ooMB?-B?-BBM---o-?-------M-foo
-B-ME?--?-oo------BB?o--B--?-M?-?-M--B-M?----E--M-M--o-BB--B?EE?M--oB--oM-M--M-o-E?-oE--Mo---BBo---o----?o----o--BM---EB-?E--EooBB-?--o-MBB-oo----B---o?E---o-E-?B--o-o--BE-----M--?o-?MBo-M---?-o---foo
?B-?--?--BEMME-MMoM--M?----------Mo-o?E---E?------Mo-?-o-B----?o--oE?o-----MBo---?o-MM--oBEMBBBo?MM--M?o-MB-E-?B-BBE----E-MB-?-EB?-?-E-M-BB-EB----oo-BMo--BMB-B--M?-?--BBB--?M?EBMM??oM-E--o-B?o-E---foo
ME----?-B--MTBEM-TTMTo-T---Mo---Mo-E?T--MoT-MMBB--Mo?B-M---B---oB?-?BBB--o------TBT-E?-oTM-----TTEMM?-----T--MMM-T----BBTB?----TM-oE---oE-B---B-M-MBoTTM--?-B---o--T-T?--?--M???-TB-EBB?T-T-o---?TB?-foo
mBE-oB--B---|--B?||M|--|-oE-oBBE?-E-M|B--B|-o-oBMoo-MEE-Bo-oE--oEM------?oM-----|-|--?E-|oE-Eoo||B??o---ME|o--o--|-B?o?o|Mo-oo-|--B?ME-EBM?-M--BB--?B||EE--?--M-??-|-|?--M-MME-ME|oBM-M?|-|?-B?E-|BMEfoo
XXXXXXXXXXXXXXXXXXXXXXXXXXXXXXXXXXXXXXXXXXXXXXXXXXXXXXXXXXXXXXXXXXXXXXXXXXXXXXXXXXXXXXXXXXXXXXXXXXXXXXXXXXXXXXXXXXXXXXXXXXXXXXXXXXXXXXXXXXXXXXXXXXXXXXXXXXXXXXXXXXXXXXXXXXXXXXXXXXXXXXXXXXXXXXXXXXXXXfXX
