-------------------------------------------------------------------------------------------------------------------------------------------------------------------------------------------o------------
-----------------------------------------------------------------------------------------------------------------------------------------------------X---------------------------------M----------------
---------------------------------------------------------------------------------------------------------------------------------------BBBB-------X---------------o----???????--------------------------
------------B------------------------------------------------------------------------------------------------------------------------------------------????---------------------------------------------
---------B-------------------------------------------------------------------------------------------------------------------------------TT-----------------------B-------------------------------------
-------------------X------------------------------------------------------------------------------------------------------------------o--||------BBB---o-------??????-------B---------------------------
------------------XX---------------------------------------------------------------------------------------------------------------------||---------XXX------o----------XXX-----------------------------
---------T-------XXX---------------------------------------------------------------------------------------------------X-----------------||----o-o-----------------------------------------------------v
---------|---T--XXXX---------------------------------------------------------------------------------------------------XX----------X-----||------------------------------------------------------------f
--------o|---|-XXXXX---------------------------------------------------------------------------------------------------XXX---------XX----||--------M----------------------------------?----------------f
-------X-|---|XXXXXX---------------------------------------------------------------------------------------------------XXXX--------XXX---||----------------------------------o-------------------------f
---------|---|XXXXXX---------------------------------------------------------------------------------------------------XXXXX----M--XXXX--||----?-X-BBBB----------------o-------------------------------f
---------|--X|XXXXXX---------------------------------------------------------------------------------------------------XXXXXX------XXXXX-||------------B--o------------?--M----------------------------f
-------XX|-XX|XXXXXX---------------------------------------------------------------------------------------------------XXXXXXX-----XXXXXX||------------------------------T-----------------------------f
m?----E--|XXX|XXXXXX-----------------------------------------------------------------??X?????--------------------------XXXXXXXX----XXXXXX||----------E--B--------------EE|-----E-----------------------X
XXXXXXXXX|XXX|XXXXXXXXXXXXXXXXXXXXXXXXXXXXXXXXXXXXXXXXXXXXXXXXXXXXXXXXXXXXXXXXXXXXXXXXXXXXXXXXXXXXXXXXXXXXXXXXXXXX-----XXXXXXXXXXXXXXXXXX||--X--------XXX------------XXXX|XXXXXXXXXXXXXXXXXXXXXXXXXXXXXX
