-oBMB--E--?----o-B-M--B--B-M?E--B?-------E-BB-?-M-oMo-E---EBE-B---BB--B-?BE-o----EoB-Mo---??--oM-----oMoo----B?M---BM?-?-B--M?---o--BB-M---M-----?--o?----oM--o-B-E-?-MM??MMM-------M-o-E-o---E-o?M-M?M-
BMB?-E-Mo--M-o--?BE-oBB-?--BB-B---B-MB-E-M?-B-?---o?M?BB--M-?-o-------B--M?o-M-???-----??BoME--o---BM-o---M--?-EBEMooBoB----?-M-B-oE--oM-M--?oB-o-B?-o-oM-??M-?-??M?-M--o-M-M?-E-E-MM?-M?-----MM---EE-MB
?--E---B-EBo-o-BMoBE?---ooo--o-E---oM-??MoBMBE-?--MB?oMoEEB-E-BMoEoE--BB-B---B-B-MMMBB??---o?--M?--B--o---M?MM---B--E-MB--B--M-?B---MBM--MB--ME-?-B----?--?--o-?B----MM---o--EB-oMB---------BMoE--o----E
o?-M-?---MM---EEE?-MM-o?---M--o?o??--E--BE?-------M?-?---?B-B--M-?-?--?--Eo--o--M-?--?-o----o-B--?-EEB-?E-oo-E----E-?--BM-??-oo--BE-MBBo-M----B-B-?-----Eo-o-MB-------BE-M?---?--B--?oE---MMMo?--oE?-B--
-M---BBB---oE---B-B--o-E-M-B--M-o--EM-ooM--Bo-Bo---o--BBo--M--M-o?EM----M?-E--?---Boo-E-ooB-B-?-M--M----M-o-----M--o?o--o-M?--?--M-oMBM----?E----?BM?-oo--oB-o?EM-E-?-M-?--oBM?-?-oMo-?----?------?-o?B-
---B?BE--o-E?-o--?Boo---E-o---M----BB--?-oEE---MM??-?B-ooM-----B-B-oo--MMoMMM-o-?---M-?--o--ooo----M-??B---?o-M--??oB--E?-o-ooM----ooBB-o-?oBB------o-MoE--oo-M---B?Eo-BB-oE-MBB-?--Bo-BoE?--EB-B----?--
-E---BMM-M--Bo-o-BM--E-M?M--M---ME-B?-M----B--E--M?--B-MoB---Bo-MoE--??-o-B?MBM-M--E-o---?-o-----EB-?-M--B----Mo-E?-BoM-MEM-E--?Bo-?-MM-M??oBMEE?BoB-?M--MoEE?oMoM?-MB-B-Mo-B-------M-o--M-B-?-E-MB???-o
EBoBM-o-MM--M-oBo?o-M----oM-----MBoM-------E?oBE--oE-M?--EB?-oM-oo-------M-oEM-?-E-Mo-B-??-----E-?Moo--------B--B?o?-?o---?--M-------M-o---BM-?BB----?M?-MMBMB-MoM--M?oE---o?-EoM--MB?oE--o-oBo--M----Bv
-BEooo-M---?---o-M---o-MM--E--M?-o-??oM----BME--?B??-?o---Mo-B---ME--M-??-B-M--B-M----?-MB-?-E-M-EMM---?-EB--?B-M--B?MoMBBM?-EM-oE-o---o-BoMM-Boo-E---BMoM?-o----M-?--B----o-o---o-----------o---?----B-
Bo-M------M?--o?o-B-?o?E?-BM-E--M?--o?oMM-B?-M?--M-o-B--?oM-?oo-M?Mo?M--o-oM?--MB?-o--Eo-oB?-M-M-MB-EME??B?------E?BE?oBoo--??---M----EE-EB?M--??-MEB--EE----?E?o-?--o--o--EEB--o------?BBE----?E?-o---o
--o-----B---oBBEB?oo----B------?E-?B--?--??--o--oB-EMB?EB-E-?--?-?-o-oo-M--oB?o-?M---?Bo-----BB-?-M?----Mo-----?B--BMMo---MEB-B-?-E-o-?-M---E-E?EooMB--?M--B-?M--M-E-M?---MMB-?--MoooB---?---EB--E-oo--M
---o-oB--B-o---Boo--?o--oM?Mo-E--MMB-o-B?---BoBE--BBMMoMM-?-oME?-oEo-E--oME-?---M-o-oM?o-M-o-??E?-MM-BEB-Mo-?o--E?-----EE-EB??oEMo--B----o---B----?--M---?-o-?M--B---?-o----o--oo-M-?Bo-BM-BM-BBMBEE-M--
--E--------E-ooB-?-BoM--MM-------?---BM-o--ooE-?M--E---E--------E-----B?-oMMB--M-oEoM-B-Bo-Bo-----o--M-BEM--MB-?--T--E?-?-----B?-MBo?o-oTE-o-Mo-?-?---Bo----oB--oB-B-BBM-?E-M--?T?--?M?-o--Bo--BE--B-B-?
-M-M-M--BB-B--B-ETB-B--oET-----EM---?E-o-oB-?--TEoo---oB-E?E-?-o?E-o-EE---TE--o-B?--oo-?-EoT?-oTM---?BoMB-T--EoEE-|oEBTEoo-MMBT?--oTB-B-|M------TM--?--?-MM---?-o?--?oMM-T-M-ToT|-o-o--o--?--B-oMoT---T?
m?MBME-B?-o?BMoM-|-?-E-M-|-EE--B-Mo?E-ooBBo-oME|B?-E-??ME--M--EMBBEE?-MB?o|M?E?-B--o-ME-MMM|-MB|--oMEB?E--|?-B-?M-|E-B|M--BEE-|o-?B|----|oMBo---|--E??EEMM?E-ME?o?----E?B|B?E|B||oEM-oME-E?-MBB--E|--?|-
XXXXXXXXXXXXXXXXXXXXXXXXXXXXXXXXXXXXXXXXXXXXXXXXXXXXXXXXXXXXXXXXXXXXXXXXXXXXXXXXXXXXXXXXXXXXXXXXXXXXXXXXXXXXXXXXXXXXXXXXXXXXXXXXXXXXXXXXXXXXXXXXXXXXXXXXXXXXXXXXXXXXXXXXXXXXXXXXXXXXXXXXXXXXXXXXXXXXXXXX
