BB?-E--------o---?M-o-?--oBMB-oo-oM-B-?--E----o-M-M--o-oo?--B---oE-M-M?o?M--M--?--B?-M-MB-M?-o--MMM-M----MM-M-M--?M-?------------MB?BBB?---E---M-o--o-E-B-?ooB-Bo---B-B-EME-Bo-M?-??---?-o-BBBo---o---oo
MM--?----M--?-E--o--E-M-B?o---o-B-MMEo-?---B?-?-B??-oB--Bo-B-?-E--o-M--MMM?E-----MoEoE-?MM--??B-M-B------M?EBMB--E-B?--B---o-?-??BEBMMM-o-----o-ooB--o--?B-MB-BE-E-M---oBBB-o-E?E-??BB---?B?o-B----EM-oo
???EM---?B---MB---oMMMB--E-EMo-----o--o-Mo?o--B--BEMB----o---B-Mo-o--o-MEMo-M-?-BB-MoME?-?o-MBoBo-o--???-oo-EE-oM?---E?MM?oo----B--?-oo?--o-B--EoM---B?oB--?-o-B---MB-ooo--MMBM-BB?M-Mo-B-?Mo-B----?--oo
-B-M--B?o-ooE-MM--MBMB-B-?-?MEoB?MMM-oo-o-M-B-ooBM---?EE-o?MM---Eo-?----Bo---o----EB--M?----B------?o-?--o--?B--EB---?-o----??o?BM-oBB-?E--E--o-MM----E??-oB-MB--??-M-o-M-E--------ME-o-Mo--EooM-MB-o-oo
oE--EBMM-o?-M-oMMM-B--o--Bo?MB-?o-M--BMM--E?o-o--Mo------o?M?---B--oEo--M-MBM?-B-E---ooMo??Bo---?-MM----?-B-Mo--?BEB-B--E---o?EB--M??B-oBMoBM-?o?M--M--Bo---??E--?-E--E---M--ooE-o--?---M-?E-o--ooE-o-oo
-BoM?M-BM-EB---o?oM?-BE---B-M?---o--B?M-E--MM-MMB--B-E?E?-?---?-B--o??-B--B--?---M---EB---?-E----BM?-E--oE-?-----M--E--oMoE---B-o----oM-Mo--?ooo-M-Mo-?--Mo---?-BMo?-B---o-o----?Bo-o-E-Bo--o?Eo?-----oo
-oB---oB--MoB--MBB?---M?o--MM---o-----?EM-B-MB--?----B??-oM---o-----B--??o-EBM-o-BB-----E-EBMB-?BooB-M?-??BB-M--M---Bo-o--?-o--E?oME-oo--Bo?-M--o--oBB?-o---B--o--o?--E---EBBB-M---B?o-BB----MB---o-?-oo
M-E--o?o??-?B--M-Mo-oo-----?-MBB-M--o-M?-o-B--M--?oo-?oMoE?-oBo?-BE-BMoo-E??o--E?EEo?-o---????---B----B-E---?--E--o-??E--??----?----o---??Bo-?B--M-E---M--o?---MB---ME---o?-----B---?---?EB-o-MMB-E--voo
----?----M--B-oMM----oo-??-EooM--------oB-EEBE-Mo-------o?M--o-B---o-E?B---o?--??M?B-oMMB?-BB----Mo?-E-B-E-oB?-?-Mo----E-M?o--B?MEM-E-o---B-o-M--?o?--?-B--??B-MM-o?o--?o----B-B--?-?--Mo-o--oB-M--MEfoo
--?---oM-M--o-Eo-E--?-B-o-E-?-Mo-oMo--oM-EMBoB-o??M--EMB-----?-M---EM--B--o-E-B--M-----B-B---o-B?MEE??B----------M?--B---o-E-MB----??--BM?M---oMBB?B---oMBM-?-----EEBBM--?-?---o??--o--?MBo-B-M?---MBfoo
??-B----oMoo-oB-EM--EM-Boo---BMB-BEME-M-o-B-M-M-B-Mo--?--?--o-o?-?---EE-o??MM--EB---o-B-BE-?o-?-BEB---MMEME?--?Bo---M-oB--o-E?----?--MoM?MMB-oo-?o-oooME-?E--o----??--o-oB?ME-----Moo-EB-o---?M--?-M-foo
B?o--?-o----B--B--M-?-MB--o-----??M-BM-?MB-?E-MM----?-M-BBoMM--o-----?Bo-?-BoE---------?BB?MMM?-M---ooBE?--Bo--MM--o--oM---M--E?------oM-MB-M-oo-B-MM?o?-oM?-M--?oBBME--MBB------E-----o--o-?-----o-?foo
-M?-Mo--oB-E-o?MB----M--BEBM--M-ooE-B?B--E-MM--ME--oo?M-?-------B?-----MB---E--Moo-?---BE-------oMT?M-oMo-Mo-BM-M----MM--oB--M--M?o-B-MTE?--o----B-----?-E--M-M-o?--o?-----------B--B-o-MBM-MB-?E--MMfoo
-M--T----ET?---EMB-o-TTE-B-T-oo-oBB?-oTMBMM-?TBM--M-B-TBE-?B-E?B-M?--M-M--TM-B----TM-MoEMT?T-B---B|TM-o-T-?B--oE-M---B?--T--o---o-E--Mo|-M-EoBTTT---?ooTTBBM-TT--?-E--TE-B-o-EEE---B--BMoM??-TMB---?-foo
mB-E|?BEB-|--BEM-MMoE||MEM-|?EME--EBE-|-EM-??|--M-BMo-|E---MMMME---?Mo-oEM|B---E-o|BEBB--|E|o?----||B--B|----BE?BoB?-EBoE|MB-M?-Mo-Eo-?|--oMMM|||-E?Eo-||-MM-||EEM-?BE|BMo--EBM?EB?-BBMMMo-ME|-EMEo--foo
XXXXXXXXXXXXXXXXXXXXXXXXXXXXXXXXXXXXXXXXXXXXXXXXXXXXXXXXXXXXXXXXXXXXXXXXXXXXXXXXXXXXXXXXXXXXXXXXXXXXXXXXXXXXXXXXXXXXXXXXXXXXXXXXXXXXXXXXXXXXXXXXXXXXXXXXXXXXXXXXXXXXXXXXXXXXXXXXXXXXXXXXXXXXXXXXXXXXXfXX
