MEo?-EMMoo-??-E--E--E-o--M---B--M-?-ooo--B--MoM--Bo--MB-B-E-oB-E-?oB-----E---??--MMo-BM-BMMM----BE--o--B-MBME-M---?-B-Bo-M--------B--E-Mo--?EB-oBMoMEBMMo-MEM-?-?---o-E-?M---M--oM-B---oM-?o---BBo-o--oo
o?-M---BMM-oMo?-B--E?E-E-B--???--?---M---B-EE-M--?---ooM-oMo--o-M----E--M----B?-E-M--o-B-o--B-B---o---B--?-BB-B---o-------------E?E-?B--Bo??M---E--M-?--oEB----B---B---?--oo?-M-M-o?--o--??E--E-o-B-o-oo
-M?--ME?--E-?-MoB-M-B?-B?-------M-BoB--E?B--BoB-oM-----M---o-MB--o-----?BEM-M-o-M--o?-B-?oBoBE-oEB---B---B---B-------E--o---B-M-?-MB?M??---M-??E?o-?--E-o?-?o---B---B-M-o--M?M-MBE---BB-EoM?-o----E-?-oo
--?-EB?o--?BM?-M--M-MMM-Mo------?-M-MEEBE----oooBM-B--oEo--E-M?-E?-o---B???--?--oB-o-M-o-Bo?o-B-B-??-B?-oM---?oB----o---M---?-B---oMB-B-EoM----MB-?M--?MoM??-oM-B--??-o-ME-MoB--E-Mo-EMBBB--o---BoM?--oo
-----o----o--o-?--MoB-MoB??-Mo-E--ooo?---BB-B-----o-B?-?-B?----o--MoB??-?--o?M-E-M------B--MM?B?EM-M--Boo--E----------E--o?--?-MM--?---o??B-?-M--MB--oB?--B-B--?M--EMo-B----Boo?M----??-?-Eo-M----ooM-oo
?-Mo---E?-M??--E-----Mo---o--?M?------MM--B--ME?-?--?oBEE?-BB-BM-M?M?o-----?M-o----M----oME-?o-B-o----B-o--Mo--M?-?-M--B-o-o-o--MB-o-o-E-M--MM--o--------B-BEo?----M----E?-----B?o-o-oo-M-B?E-BMEoB---oo
o--M?o-M?--oo--MM----E--B-M---MB--E--?--BE-BoMM---ME---BMB-Mo?-M--MB-o---BM?---o-----M-o?-M-E?---M-?Mo?-o--BEoEMEo-M-BBM?-?M??B--M-B-M-BM-E-M-EB---EB----oMB--M-M?--o-B-M---o-B?Bo-MMoo--?-o-?--BB??B-oo
oEEB----E----M-BBMEoE?-?--o---??-EB--B?o?---o-?-M--BM--o-EoM-BE-BoEMEM-E--oMo-M--oB--?o?--?-?-?Boo-Eo-Mo--M--MBo-?B-BMM-o-?EE--B--?o-E--?E-?--?oo?o------oB-oBB--?o----------BEE---?-B-B-BoEM--o?B-B-voo
-M?-oB?-M-E--oo---B----B-M-E--?--?--E-BMB-o-?--?B-MoMo--E?MMoMB?o--BMo-?o--EBoM---o--?-??M---oB-----Bo?-?--??-----?B-M-E-M-??-o-?M-M----?M-----?--?M--Eo--?-E?Moo?BEBE-?Eo?M-?M---??o----M----o----?-foo
BB----M?-oM---?-B--EM-oE------oMM---?E?------B--BBE-??-BMBM??--ME-----?o-?--MB--M--BM-M---E-o----o-B-o?---?-o-??-oE?M-E-?--ooMM---BEB--BM-?--B??Mo----MEo----B-?-B-------BoMo?EMo-M-----oE--M--------foo
-?---?-B----M-Bo-M----E?oBE--MMBMB-M--?-o-o--BB-o-M?-MoEEBo--??B-?M-MB--?----?EM?E-M?---MoB-oM------o-E--oo-M--EB-B--MB-M?-?MMo--BM-Mo----E-B?-----?-MEB-BME?--BM-oB-M-M-B-ME??-B--E---E?-oMM-?--oE-Mfoo
----MB------?E-o------?--M?-B---ooE?M---o--?o---B---MM-?M--?-B--?MoM?---?BMo-oM--BM-BB--BB-M----o?o-ooB-M-M-B-BBBE----MM?--E------?MB--o??B-B-?o-E-Mo-B?B--?-?-o-----M-E--o-----E-M-B--?--------B-?--foo
E?-oB-ooo--B------MB--T--?M-----o-B-BooEBoM-----M-o-M---oo?MEM-M?--M?-E-ET-?BB--?M--MB---?BM---oo-Mo?-o---B----ME-o--------?-oB---?ME-----EE-BB?-BBBMEE-M-o--M--?-B----?----M?B-?-?-oB------o--EMBMoMfoo
M--T-?EM---?Eo--Mo--?-|o--To--T----oooEBT-?oo-B-o-BM-EooBBT-?---E-EB?-T-M|?--ETMMB-?-EM-B-EMM-----B-?--B-o-oToTTB-----EM?EMMBTo-?-??-T-oE?-ME-o?--B-E-ME-o-B--oTTT?----?o?--oB--?T-?-MTETB-M-To?TT?ETfoo
moE|Eo?E-oEMMB--Mo-E--|--o|-?-|--BME-EBE|EBoM--E-o?BBM----|MM-BM--MM--|B?|MMEM|-E?Eo-M-MMMBM--Eo-?-MEE??--EM|-||--o?B--B-MB--|---??BB|-E-MMo-B---o-oM-M?MEB?-oo|||-?--E--EMEEMMM?|E-oE|-|MEo-|EB||M-|foo
XXXXXXXXXXXXXXXXXXXXXXXXXXXXXXXXXXXXXXXXXXXXXXXXXXXXXXXXXXXXXXXXXXXXXXXXXXXXXXXXXXXXXXXXXXXXXXXXXXXXXXXXXXXXXXXXXXXXXXXXXXXXXXXXXXXXXXXXXXXXXXXXXXXXXXXXXXXXXXXXXXXXXXXXXXXXXXXXXXXXXXXXXXXXXXXXXXXXXfXX
