E-?MMEM?-ooo--M--oM---?o--M-BMMo-B-ooE-?-?EB??------E?-?E--B?M---E--?E--E-o-o-?--M?--B-------MB--B-?E--M-BB-oMM--BB--B--Bo-?Bo---o??o?M?MM-E?Eo-M--?---?o--?-o--B---MM----E?-?E-B?B-oo-?B--------MB-o-oo
M--oBM-?o-M--M--BBoB-o?o-oB---B-E-o-B?MEE-B--MM--?M?--M-MEoM?--o--M-EM--M--M-----o---?-BB-B?oMM-----M?Mo-----B---?MBE--?B-?o--?BB--MMBM--M----E-B-?---MB?--B?-o--?oooBE?-?--?--oM-B-B--oB-B-M-?---oB--oo
-M----M?E-o-Bo-EB-M---MBMM--M-BMMo-M--B--BoB-B-o-E?-o?--?-B?o-?---o-----E--o?o-?M-E-M-B--B-o--------BE-oB-E?o--B--oM?M--M---?-MEMM-o---?-oo---?--M?---B?E?EEoo?-----?--B--?-Mo--MB-E-oM??-?MEBMMoM?o?-oo
?-?M--M--BM--B?M?-M-M-?M-o--?--oo?--?-?--M?--?o--B?oBBoB--o------BM-Eo-?M-oM-o-MME------?B?----?o-??-M-?BMBoMoM---oM-----Moo-E-BBo----BE?MMoEMM?MB--oMo-M?BB-?o?--B?---oB-?EM?-E?-oB-MM-B---M-MB-Bo-M-oo
BEE-EB--M------oo----o-BME--M--?-oM-?---?B-o-BoB?BB--o-Mo?M----M-M-??EEE-?---M-M--M--E-?--B?-EBE--M-----?M---BB-B---o----EM------o----o---o-B-MM?M??-oMMBo-MM-oBE?o--?o-BMBBME-MB?o-o-?E---E-MB--?-Mo-oo
--M?B?MMM-ooE-MB-Mo?-BoB---M------B-E?-?-o-??---M-MM--oE--M--E-MoB--o-------BoMM--?o-?o--oE-??oMBM-E-BBMB-B-oBM?oo?-oo---BB-?----oE-E?-oMM?B--BMo?-o-o---oo--o--BM---BMB?M-E-MM--?EM-?--BM--------o-B-oo
--E?----M-MM-??E-?-M-o-BEB---MoB-MB-?MB-?E--o-BE-M-MB?-B--MB---M--M---Bo-o--Bo--?---BBB-MM?--B-EEo-M-?BoE-B-o--BE-MoE---MB?o?o-?---BMB-M--B--o-Mo-?B?-?E--EE?M--?---oo-oBMB?---o-BBM--E---E-----MMo---oo
BoB-?E-E--o-M-EBo-MBB??-?B--B?-o-oME-B-oMMoMo?--?B?-M--?B-EM-EoM-ooB?-B-?o---oMo-B-o?---EME-o-------M-E-BMM--o?M--??--B--E--?-o-BoB---E-BEMMooM-oBo--B?---??---MB?--?---?M?-----B----M-Mo-----?E--Mo-voo
--o-o---E-oB?MMB--o-B--M-B-EB-EMEM-----------MooM---M-o-E---oB---?---?Eo-BE-oBB?BE---B--M?-M???--MEo------B----B-E?--?-M?MBB--M-oM--?E---MM-?-ME?-B-MB??-?---M?MBE-B---oBMMM---?-E-o--?--oo-?Bo?-oBM-foo
-B--?M-BB-?-BM-?o--M--B----M?-MMMB--B---o---M-------B-o---E-o-B?--oM--Bo??-?oMM-o-o--B-?o--BB-MM-MM---oo--BMM-?B??B-?-?--?oMM-----oo-??--Bo--MMB-MooM?-EB--B--o-o---E--o-?EE?-?MMBM-?-BoE-?B-?oo??-BBfoo
-----MB---E-B-?-B-M-oo-o?B-M-M?M--B--B-M--B-B?-o--B-------MEME--MM---BoMM----EM----E?o-?M?-oB--B-?-BMBE-MMoo-B-?--?-?MM--?-B?o---?----oo--oB-M-o--M--o-M--ME--oBoME-M-?oo-?----MM--B?-?-Mo-??--M--BBMfoo
--M----B--M-?M--MB-o-----??-----M-?-----B-Bo-----BM--M---o-?B-E?TB--o--o---M-BM???-M---?M---E-oME?--?-B-M-M-----B-M--oB--B-BME-o-oBM?-MM--o-------MM--o?oMB---o?M--MB-B-----MB-M-M--?M--?-B-M?-oo-B-ofoo
--o-M-oo?-Mo-oM-?-oBMM--oo---oEo--B--o--o--o-oM-EEB-?oo?EMo--M-o|M--M-B-o------M----BMB-B-?oM-oM----M-Eo-E?EE--M?--o-MBooo?o-T-M-?Eo-------B---M-EM-???--EE-?B--Bo---M-T--oM-BBB?--oMT--M-oBME-oM-B-?foo
--To-B--BMo???T--oM--o-M?--M-?-Eo---E--------?o-M?--?--M---T---T|T?-TEEB--?-??T---BTMTBMToT--o?-MoEB-EMB-B--TM--o?E-TEMM--B-B|??T-B-o--B-B---MoMM---T-BTBM-M?-?E-M-ME-B|BEB----?--B--|---B-E--ooB-oMofoo
mo|ME-B?MB?-?o|-ooEoE--o--?MBEo-E---B--?M?---E??M-?MBo-ooEE|EE-|||Mo|BMB-o?--B|--B-|B|oo|-|BM?-M---o-M--MoM-|EB-MoMB|MM-E--BE|--|??-o-o--o---EM---E-|-M|-----oEM----MoM|o-B?---EE-EE-|?EB?E-----E-?EMfoo
XXXXXXXXXXXXXXXXXXXXXXXXXXXXXXXXXXXXXXXXXXXXXXXXXXXXXXXXXXXXXXXXXXXXXXXXXXXXXXXXXXXXXXXXXXXXXXXXXXXXXXXXXXXXXXXXXXXXXXXXXXXXXXXXXXXXXXXXXXXXXXXXXXXXXXXXXXXXXXXXXXXXXXXXXXXXXXXXXXXXXXXXXXXXXXXXXXXXXfXX
