B?-o-E-E----oo-MM-M---Bo--B---B-Mo-???-----B-BB--M-M-----B?M--oB-BoM--E--?BBBooM-?MB------EM----?MB--BMo??o-oM-M-M-?--MM?--B--MMB-?B--M--MMB----?MB-M-oE-o-o--?o--Eo--?---oBBBM-M--MoM?----M-Bo--?--o-oo
MB------M?-?B-oM-E?--oB--E---?B--?o--B--MMMMBM-oMM---o?-o-o-E-oM--?-----B-M-?--?--o--M--o-?-?--oM--Bo---E--M--o-?--o-oB-?oBE--Mo--?--M----E-oBo---M-Moo-?B-M?MM-oBM?E-?----BMMB--E----Moo-o-?M-?---o--oo
M-?o---BMM-oBEoB-----MM-B?----Bo-M----?-?o-o-M?----B-E?-M??----M---o--E-M-MoEB-MB---E---M-BB-oEo--MB--B?BBM---E-M-o----B?-?B--ME--M----?---B-?o?---E--MoB----B--B--B?-------BE----ME-B?--MEB?---o?----oo
MoM-MM-MMo--EB-M??o-B-?-B-oMEoEoBB-E------o--o--?--?BM---B-?EBM----??o----M-?--M-B?-----ME?M?M-BBB--oEB--?-MB----oM-??BBB-oBM-M---o-EM-??-oo---B-o---Mo--?-oE--o?-?----E-B--BB-BEooB---B-BBB-B--o---M-oo
--M---M-BM----M--B---oBBoB?oM---E?o----B-M---oB---BM?---?---??-oB--o-B---?--o-----??-E--MM?oE?-?-BM?-M-o??--E----?-BMBo---?M-M?-E?Eo?-?MBo--MMMB---MoMM---B-Mo----?BB--BBEM-o-------------B?o--?-MMM--oo
-B-o-MBoM-B-?o---?--MM--M--o-o-EBB-BMM?-oBo--E-M-EoE-Mo-M--o-?E-oEM--?o-oMoBEME-oB?o-B-E-oo-?ME-oEBBoM-o?--?BBB?-EB-BB?-----M-MEBM?--oo?B?MM-????--MB---MB-----MB-Bo-?-BoBM--MoMB--BB-EMM-BEM-oo-B--?-oo
-MBo-?-o--MM---------E-BM-oM--M?--EMoBM--o-o--EB-M-M-E-?--o-M-MBB----EoB-?-?----??-?B-B--M---M?--MBo----o-B-B-------BBo--BB-BoM-BB-E--?--?-?--E--BM-B-BM-M------o-o----MMB-BB--o---o-o?-?-M-o-?-E-EE--oo
?--B-o--Moo----E-o------------Bo---E--MEoM--?------?-B-MB-?B---?-B-MM-o?-Mo-?oB-MBo-?-?o--MEEoB?--MB-E-----o-o----E--EME---oM--oM--B-----ooo--?-B?-M-B--?-----?MB--o--oB?M-oB----o--B?o-EMMo---BBBM?ovoo
o--?---?--B--E-?----MoEEBo-?---?-oE-EB---o--oEo------o---o??ME-?MB?o-?oEo-EE?-E--o-?M??BB--BM?M?---o-?-B----?--M?-BM---BMEM-o--M?M-?--M-?--?oBBM---?MMMo------E--Mo---E-MB--MEM-oo-o--M---Eo-----M-MMfoo
B-MBM---E--E-??B-Bo---?B?----o-E?BM-M---o-B?o-B-E--?-?-o---E-M??o--EM----------M----BoMBooEoE--oB--?-?EB--Bo-E---o-??--oo-----BB?-?o-?E?B-B-BBB--M-o---E-ME-?-M--BE--o-BB--B-MooMM--Bo----?-------M--foo
o-M-E--o?--BMEB--o-o-?M---?M-?o--Mo-?-EoEE---M-MB--E-o--oo??-B?--o?-Mo-?EEo----oB--?o-ME--?-Bo?BMM-oE?--oE-E-BMM--M-BM-?MBBM-EBMo-o-??B----B??-ME--o?B-M------o-----o-B?-o?-?M-MM??-oo?B----MB-ooMoE-foo
M-M-?--?B------o-B--EEM---BM--E?E-oE??B?M--B?-E---??-M---BEE---M---M?---M----B---EMo---M--EMB--Mo-E?-M---?oB-o?--B--MBB-BMB--B?M-o-M-BEo-E--o----M?M?--EEoM-?-?o----oM--B?--?--Mo-?To---?---?---?o---foo
M---o-oB--??--TBM?B-----M--oB---MB----M-MB--?---B--ME-B-o--?---ME??Bo?--oB------?-M----Mo---?o-oB-MEBB---------E-B---o-EB--??o--?o-?-o?-o---BoM-B?----BB?BTMM?B?MM-o-BE?-M-B-oo-?Mo|M?o--M-T?oEEB-B?-foo
M-T-ME-E-?T---|M--oB?--ME------BB-oo-?o-TE-BMB--oo---M-MB--?-?M?M-----Mo?T-TM?M-MTMTT-E----BoB-BMoB-E-M--?Eoo--To---o--?---o?---B--o?--M----o-EoB--o?-oEMM|TE-TT---?---ooT-MTo?oB-o|E-ME-TT|-??B---B-foo
mE|M---BoM|BMM|?--Mo?-M--M--oBo-?EB-o--o|B-M-oBEMMEoB-?-MB-BBEBMBEEEM---E|-|---E-|-||M?BE-MB?MoME----o--BoMo--?|??B?----oM-?-B--?B?MM-oMBoo-?o-Eo-?E--M-o?||--||-B----MMM|B-|?EBE-E|M??BE|||M--oB?-EMfoo
XXXXXXXXXXXXXXXXXXXXXXXXXXXXXXXXXXXXXXXXXXXXXXXXXXXXXXXXXXXXXXXXXXXXXXXXXXXXXXXXXXXXXXXXXXXXXXXXXXXXXXXXXXXXXXXXXXXXXXXXXXXXXXXXXXXXXXXXXXXXXXXXXXXXXXXXXXXXXXXXXXXXXXXXXXXXXXXXXXXXXXXXXXXXXXXXXXXXXfXX
