--?-------o----o--o?o---?o-o-?-?----?----o?--------ooo???-o--o-?--o??o-------?---ooo--?--?---?-----?---o-o?o--o----??--?-oo--?-?-o---?--o------o-o---o---?-?---??-?-?oo?E--EM-o--BoooB?E-oEo-?B--ooBo-oo
---?o--o-?oo??----?o-o---o?o---?---??-o--oo-?o--??--oo---?-o??-?---o-?o-o-?o--o------o--o-o?o????-------??-o-o---o---o----??---------o---?-o-----oo--?--?--o-?o-----M?M??-E--EoBo-E?E-?B?oMMBM??-ooM--oo
-?-o----?--?---?-??-?--oooo-??-----oo---?o?-?--o-o-oo-----o-?---?o-oo-??-o---oo---???---o?-??o-o-?o?oo---o------oo-?-??o?--?o--?--?-o--?o------?o-o----?-o?-?-o-----?MB-MoMBo?-B?-?-?o-o-o?oE-o?o--?--oo
----??---o----?-ooo-??-?---oo---?-o---?------o-oo?-------o??-----????----o---?-????o--?o----o---?--o-o???---??----o-o-?oo--o?o?--o?-o-oo---o-o-----?oo-----??---ooo?MBMM-?EoE?-??-Bo??MMo-?oB--o?-oo?-oo
---oo--?ooo-?o-?----?oooo-o----o-o??--?----o-o-?---?o------oo?ooo--??o-?--???---o-o--o?-?---o-?--o-o?-?-o-?--??---?---o?-?------o-?--o--?oo-?----o------o?o----?-?o-?--M?-?o?--M?-?Bo-B?-BE-oM?o?-oEE-oo
-??-o--o---?--o??oooo--o-??------?--------?o---o-?o?-??-o--------o?---o?-?-?---?---???o---o--??---o------?------??-?-?-??o-----o-o--?-?o??-??-----o?-o-----o?o-?---?o?oBM-oo?-oM?-B?BM?--B-?M??o-ME-M-oo
-o-?oo---o-----??-?o---?---o--?-o?-??-?-?o--??---?-oo?---??--o--oo----o-o-?-o-o--?-??-o--?--o---?-o-?--?o?-o?o----ooo??o-??-----?o??---??o--o?-?--?o----?o-o-o????o-o-M?--oE?BoE?oMMEBBB?-MoBEE-oo-ME-oo
--o?o-??----------oo------o-?---o----?-o-?-?--o-o--?--oo??o??ooo-?--o??--?---------?--o-o---?-o--?--oo---o-?o----?--?---?----oo---o-ooo-o??-----o?o----o??----o--??---?M-MMo?oB?oo??--MoMo-o-MBBo?-?-voo
--?-o-ooo-?-??-------?-?-?-o-o-??--???o-oo-?-------o-----o----o?o?-?----o-?-------------?--?-o?o?o-o???-------o?-?----?o?------o?---?o--oo-o-oo-??-o-----o??-?--o-o-ooEM--??MB?-?o-o-M??-B----o??M?-?foo
---oo-o--?--?o----------??---o?--o?---??-oo?----??oo??o?-o-o?--???ooo-o?o----------?--?---?-----o--o?---oo---o--????-------oo-??---?---o--?--oo---------???-?-------M-Mo-?????o-??---?MoBB?o?oM--MBE?foo
--o--o--?o-?--?-???o--oo??o---o--?----o--o-??---oo--oo-o??-o---o-o-?---?--o--o--oo----?---?-?----?--o-oo--------?o-o-----o-----o?---o------oo?o--??o--??o?-?-?----o-oM?oo-ooo--B?B-E-o-B---?M-oM-ooMMfoo
---o-o-?-?-?--??----?-?o--?---------o-?-------?o??--?o--o??oo-----oo-----?-?--?----?-o-?-?-oo--o---??-?o-o---o---------?o---o---?o-?----oo----??o-o---o??-o?----o?-?oEoB?M-oE----o--M?oM-o-EMoBMBoB-ofoo
-?-ooo--oo--?oo-----o-o????o-?--?-----???????-?--?-?o--?----oo--?-?o---o?--------------?-------o-?oo-----?o--o-o?o-o-ooo-o--??o?-o?-?-?--??o----oo-o---?oo-o-o?-oo-o-?-B?MB-B?-oBo?-?M--EooMo--B?-M-?foo
-??---?--?-?---------o-o-?o----?---?--o-----o??-oo-ooo?o--o-------?-o------?oo?--o?-?-?o------o?o?---------?o?------o-?--?--?---o--o-?oooooo?-??o?-??-?---?------?--T--MM?-??--?BoEMo?oE-MBB--B?ME-?Bfoo
m---o----------o--o---?---?-?---?---?o-oo-o---?--?--o---------o---o------?---o-------?--o?-?-----o?-?-oo?-?--o?------o??o-o-?----o--o--?--?-o-?oo???---?-----o------|o-??-o-?Eoo?o?o??-MoooMoBo?B-EM-foo
XXXXXXXXXXXXXXXXXXXXXXXXXXXXXXXXXXXXXXXXXXXXXXXXXXXXXXXXXXXXXXXXXXXXXXXXXXXXXXXXXXXXXXXXXXXXXXXXXXXXXXXX-----XXXXX----XXXXXXXXXXXXXXXXXXXXXXXXXXXXXXXXXXXXXXXXXXXXXXXXXXXXXXXXXXXXXXXXXX--XXXXXXXXXXXfXX
