-E?-o-BB-Moo---oM------B-B----?o--?MMEE-BoM-o------?oB?B-o--B?-MMooEBo-??---o-oo-oo-?--B-BBM-ME--BMB-o---MEBMM---o-B-B-ooo---E-MB-BoM-?EE--BM?-??-M--ME-----o-o------------------------o----------------
-M-EM--MoBBMooE-E--?-?-o--M--?o----?--MBB--?o--E---?Bo---B-oB--?----EM-----?-BM-?-oB-MoM-E-M?oMo--?-o?-M-----M---o-ooBB-B?-?-?---?M--?o?--B--BB-M-M-MoM-?-Bo--M--------------------------?--------------
-o-?--?-oM-EE?B-M--E--?-o-E-?--o-Bo--B??oB-E?-??E-o----B-?-B-----MM--o-M-EMEo?oBo?---M-?EB--oB--o--Bo-oE--------B-?---Eo-?o--o--BBM--o-o-MBE-BMM---E-o--??-M-M?-------?---------------------------------
-Bo----E------M-Bo-M-BB-BB---?--??---oMBoE-M-o?o?-o?MoE-B---M-M--?E-M---M--B-??-?EBM--E?M-B-?o-oBo---Bo?BB-o---B-EB--B?o-BBMB-?--oo-o--?o---?--oBo?---M?o-E-EM?-----------------------------------o-----
MMoB-M-BM------B--oM----?Mo-E-o-B?M-MB--EMo-B-MM?-B-MoBoBBo??---?--BMo--?oE---?BBM---E--B-M??BM-B?o?----?--o-o-MM?o?---?---BBM--E--o---BB?-M--?----?BEE-B-M--?-----------?------------------------------
---?-M------M-----M-M--?-EEM-M?--M-o--B-oE--?M--M--E-B-?--o-?--B----EBE-E-?M---M-E---?E--?E?--------M-o-o---B?B-Booo----?-M-MEoBMMo-o-M--B-?--Mo-Bo-MBM-?---o---------------------o------o--------------
M--M?MMo-MM-E-?--MM---oM?---B-?B-ME------?-BEoEMB-MMBM-o?Mo--?--MBoMM--o-BMB-E--oMEB---MM-B-E-?----??ooM?M-oE--o-M---o-E--B-E-?M--?-M-?-?o?----?oooB-ooMM?ooBo----?------o-----?-----?------------------
?-oM-o--Bo-?Bo-?--oEMEMBM-B-Eo-???MB?-o--o---B?M-BM?--?-E?--?---o--EE--Mo?M-??Boo?-----oBB-o---ME---B?o---o-?ME?-E-M---?-Mo----BM--M--MMB---?Eooo--oBo-oo---?--o-------------------------------------v--
?BM-Eo-B?------?-o---??-?-B-M?-Bo-M???-----EBo-M----M----?M--EMMo--M-EooE---?-oBE?EB---E?-B----BB-oB--Mo-BBBM---BBB-oo---?-Mo-MM-?----EBMBM-BB-o-???----?---o-------------------------------?-?--?---f--
---MB-o--Eo--o----oooE--B---?-M-oM-M---M---?-?----EEME--E-o??MMB---MoB-E-----??---M?o-?-?MoB-o?-----o---o??--?-o-E-BBo--?---Mo---o-M-B-M?-ooEo?-EB-E?-B?o---MBM--o-----------------------------------f--
--MM?-oo?BMB--o-o-M--???-E-B-M-BBo--?MMM-oE--Mo-M-M-MM-MMoM-M--?-M-M---M-M?oB-EB-ooo------B--MB-B--EoE-----M??M-?MM?----oEoM-E?--B-Bo?-o-o--M-EEM-E?----M-M--M-------------------------------?-------f--
-o------Bo--MBB?B----?-o--?---?MMM--M---oM-o---?M------BM-o----?M--B------?-?-M---ooMo-B?-E--?-E--o----EEo----oo-MMBooM-o-EB-B-M?B--M--oo---E-Bo--B-BBoBM-M-Bo--------------------------------?------f--
----BE-------BBB?EMo---?MooB---EE--B---oMoo--B-------MB--B?E--Eo-?o?oo--ooMM-M--oE-MM-MB--?--ME?--B---B-Mo--?E----ooE-B----B----?o?-----E--M-o-E-?-?---B---E--E-----------------o-----------o--------f--
-M-B?BBET?--T--oM?-o-E--Eo-E-oT-B--B---TM-TBo-MTT---oB-BTTTBo-TMo-M???--?oTM-o?---B-T-MB?-o-?o---T--Bo?oT?MBM----oBM-MBTB--MT-E-MBBET---B---BB--TMM?MT-oo?-BE-M-------------------------------o------f--
m-??-BEM|-oE|?-o--?-??o-MEEB?B|B-ooMoo-|?E|MoE-||Mo-B-MM|||-?-|-MB-?EE-EoE|o-?o?--EB|??-?EBo----M|o?-??E|EE--oE?E-E-M-E|-?--|B?MB-B-|B-?M--E---o|--o?|BoMoo??B----?----------------------------------X--
X----------------------------------------------------------------------------------------------------------------------------------------------------------------------------------------------------XXX
