---oMoM-----?o--?o---ooo--B--?----B-M-E---BMo---?B-B?--B-B-BEE-M---?-B-M-ooM--ME-MBoB-BMo-B?----o----MB----M-M----M-oM?-oMMM--MEo-o-?M---B-M-?----M-?-?-B??------M-M-E-o--M??----Mo--E--?oBB--E-M-?---oo
-?-EMMB--o?-BMMM-?-?ooM--o-ooo--?--Mo-?oB--o-M?E-E--B-BBB-?--MME?--MBoMB-?--E--?--M-----M?E--oo?-MEM?---??-M---?--oM-E--?B--?o-?---BEo-Eoo---B----?-o------?-EE?o-o-------?B-??M----?-?-B--------M-E--oo
?---o??--?----M--MMBEo?---oo?-BB--B-o----o--B-?-BBB?-E-M?-M----?-?Mo--EEo--M-Mo-?--o-EM-BM-?M-B---BM-BM-o----M-o---oo-?B---B--MBo-?o?--B--oBE-ME----B-----?--B---MB----?-M-oBoo??Booo-?oM?M?---BB-B?--oo
-?E?-o-M-B-----B?--?BB?-o--M----BEB-Mo??-E-BE---E?--E?oM?o--MoBM-BMBMMMM---M--B-M?-----M----Bo?-M---E----M---Bo-oM?oME?------B-BEo?M-o?M-o?-M?EBM--EEM?B--Mo?----EEoBM--ooB-E--oB-o?BEE---oo?E-BB?o-o-oo
M-B?-M-oEB--o-E?M---Mo?B-M------B-E-E-o-??E----B-BM-B-E-BB-MB-M--oB--oE-BE-E-?----o-?M--B-?MEMB-?E--?o-M-B-M-?BMM-B--MM??-MEoE?-?--?B---B-BM--M----BM-oo---B?MB---?Mo--?M--MB-----E-E-B-BBo-o?--o-B---oo
E?M-Bo---M---B-B---?---B--B--MEB?MMo---M--M-oM--B---BBMBE-----------Mo-oEM-?--E---Eo--o-BooEM---M---o-B--BEE-----MB-o-B?E-?---B---oE-----oo---E--M-M----oM--B?Bo-BEB?MM?BM-o-BM-BBB-?--BEM-----EM?-?E-oo
M?--?--?----Bo-B--MB?-?-ooM-BEB-?--?oM-M?Eo?--B---oB--BB--o---EMo---Mo???o-BE-M-?B?M-E?-o?MMoB-BoM???-M--MB-M--?-oBM-MB?-oE----o-BoBo-MBMBMB-?-?E-?--MBMM?BE--B-Bo-M-B--------o---B-M-oB-M--B--M?-M??-oo
B---B--M--M?M?MBM--?M----o------MM-M?-?-?--M?-?---E-B-------?B--ME?-?BBooo---?Mo-o?B-M--?--o?---E?-?-E--??-?-B-oo?--M-Mo?-BE-M---B-E-M-Mo-o-MEo---Bo?o------oM--?o---B-?--?-?-o?-o-BE--?E-----?-MEM--voo
?-B-o-?-------BM-----??-----E----oo---Bo--BM-BBB--Mo--?oEB?--M-----EE--???M-?MoB-B--EMM------B-B?B?--M---o-----M?o-?ME-?oM----?-E-?Mo----ME----BE-?--Bo?---o--o-o-M-----o--o-Bo-oM-BM-oE-o-o-E---B-oEfoo
o--M-o-?oo---oE-MM-?-?----oo-----EE?-BoB-M??--M---o-EoE-M---Eo-?-M-M----E-----B-?oo-B---MB-E-M--M?--E-o?-?E---M--B?o?-E-E-M?-?B--?--MoM-ooM-B?o-BB?--B--B--E-oMBE-M??-oB-?---MMMEoEMM--B---?o-EEM---?foo
?Eo----?ME----B----Booooo--Bo-----?EM--o--oBo-?-EE-??--B----BMoEB------o--MM-M--o?-E--B-----Mo-M??--MB-Mo-M--oEB-o--?-M-BMM-EoEo??-oB----?E?----E---??ME-B-B---------B??oo--B-----?---o--oBB---B--o-?foo
?----?B---MM--?-M----?-?E-ME--?M-B-M-------?B------?-oB-M------M-?--?-o---EooM----EM---MoE--E?-?---E-Bo---?T?-BM-Bo--------MM-ME--E?-oM-BB--EMo?--?--?-B-BBE---?-EBEBB--E-o--B-E-?-M-??--oMB----?B-M-foo
M---?-M-??--Mo??-o-E-------M?M-E-T??oM-o-BM-o--o--o?BE--M-E--?----Eo-BB---Mo-o-----?o--E-M-oME-o?Mo--E---??|--?-BoM-----M--B?o??--??B-o-ETB---oM---MM-----o---o-BM-?-o-EB?BB-EoT-----Booo?--M---o--MEfoo
--BM-TTT-T--o-----MMM?M-To-MT-MBT|--B?---?T--M-BM--B-T-----E?o---TM-o?---T---?-B-B-ET--MM?E-TMoT-oEBEB-?-?-|-MT?-oo-T----B?---?--oo-MB--M|TTMB--M--ME-BoM--oE-B--?-E?TB?-?-M--B|E-?-B??MT-M--E--E-oB-foo
mo?EM|||B|Bo-o-B-oBE---?|--M|oBo||-o--?--o|E--E-o--E-|B-E-----B--|-E----o|B-BooBoo--|?E-oM-?|M-|M-M-?MEB-ME|o-|-EE--|o-?-?--o----B---MM?B|||??-o-oB-B-M---E--E?----M-|--B-E?--B|---oMo-o|-o-EB-BMBoMofoo
XXXXXXXXXXXXXXXXXXXXXXXXXXXXXXXXXXXXXXXXXXXXXXXXXXXXXXXXXXXXXXXXXXXXXXXXXXXXXXXXXXXXXXXXXXXXXXXXXXXXXXXXXXXXXXXXXXXXXXXXXXXXXXXXXXXXXXXXXXXXXXXXXXXXXXXXXXXXXXXXXXXXXXXXXXXXXXXXXXXXXXXXXXXXXXXXXXXXXfXX
