-M--?BMMoB-BME----M----BM?B-M--EM--E-E?E-M?---o-?-o-?-?-o-B-M--oo--M--M-oM--?MB-Eo---o----?M?-E------E-?-----B?B?Bo-M-B---M----ooMBo---M-o-B-?-----B-?oE?o--EE--oMo-B?M?M--BBM---MM?MM-BB-M-M?-Moo-Mo-oo
E---M?-o-o--B?-?o---M-B---B?-MB-M--M-?BB----B-?Eo?-?oE-BEMoo?-o-Mo-B--B--?--B--BMEoBE--------EMo-M-oo?-oB-?B-?BoMB-?ME---B?--EM--o-B--oEM-oE-B-oEMo---EB-?MBBB----?M-Mo-oMo--B--o-M-B?EoE--E-ooBE?-B--oo
?--o?o-BoB?--?-E--M-B-o-o---E--?B--?---?-Mo-?-?M?-?B-B--?----B---B--B-?oBoM-E-o-B--o-----?M--M-B?M---E-----o---B?-----B--EBM?--BEEooMM?---o-M-B-?M-B-M?---?-E-B?--Bo-M-?Eo-----oBMM----?B--?-E-MM---M-oo
----?--B-?B---o-oBo-B--?BMMB??-B-?--MEoB---?--?--M---o----ooo-?---oB---???-oM?--?M?oBE---?M-?MBEE?o-oM-?---E-o--oM?---?--?----?-BM-oM-?oB?-?---BB--E?---Mo?o-----?-E-?oMM--oB-??BB------BM-M--?B-oM---oo
-B?MMM-----?--BM??--??Moo----B-ooBo-BM---Mo--o-E-----BM?--B-oo-??-?BoMoo??-E-----o?-MBo-??oo--M-?----M--?---??-------o?-EB--EEo--o-BEo-BE-BBo--oo---?M?--M--B?--E-B----M?-MB---oB?MM?o--E-B-oB-Boo?---oo
oB---B-?MMEE-?-o?B-Eo?--M------?ooM?BE-oMBM-oBoM-M-oE--?-EE-MMM-?--?MBMo--o-E-----?BBo?-oB-oo--Eo?BEE?MM---B?-??--E--B-oB-o--M---BM-B?--B?-oBo-o?--BEM-o-BMEM---?Bo--MB-B-M-o---M?M-BBM---?-----?--oE-oo
B-----E-o-------------oB----E--?o---??o---Bo?--?-BMMBoM--Boo-o-BoB?-?-o--?-?B-MM----EooBM?---M--E-?B--?----BMM--EE--o--o--M--Mo-M--BoEEB?------ooo??B-----M-o?Mo-?o-?MBMo-B?MB-MB-oB-M-Bo------??-o---oo
?---MEM?EM--?-E-E---BM--oM-oB------?-----E--B--?o-ooB?E-E--?M-?-?--BE-oB--BM-??Moo?M----o----M---M?o----M-BE?---MMM-M-MEMo---Mo-?M?------M?------oo-M-B?EB--o--o--oMM----BEB-----o-MEM?M?Eo?-?-B--M-Mvoo
o---?M?----?M-?E-oE--B-M----?E-BM?-Mo-----o-o-EM---B---oM-M-B-Bo??--Bo-----B-oM-E----Mo-?-B?--o-??-Bo--o-BM?--E--o-EM---M---?ME-MB-o--?E--E-?-M--EBE?EM-B---?-ooo---M----MB-----??oB---oo?-B?-----M--foo
E----?o----o-??BM-MB--Bo-----?M-E-B-o-BEM-------E---oE-M?--?--oM?-o----?-o-E?M--??E?oo----M-B-?----BBBM-o--MM-B---BBM-----BB--M-BBM-?-?MMo?o-MoMM-M-BB--?B-M-MoB--Eo-MB-B-MM-?--?Bo?E--?EMo?EB?MB-o-?foo
?M----------o?-M?EEo--o-??ME-B-EMoE--M-?-EM-o-oBBM--?---M-MM-o?Mo-MM-?E--M-M---E--BBBM??BM---o-?-M----B?Bo-o-B?E-M-?MB-oo-?---E--E----BM--?---EE---MMMo-oo?---M?-M?-E?M--M??-ooMo--?M-?---?-M?-ooE??Mfoo
-M--------B-MM-?EM?-MM?-M--M--o---?-?o-?B--B?M?oo-o-EoB--B--B-----ME-?--?oo--?M-E-BMM--M--M-??---oo-MBo?----BoMM?-o-M---M?E-?B?-MB-E---?M--?o---o-o-?--oE-E-?o-?MoBoM--o--?EM?--?B--o-MB?-?MM-BE?MoBofoo
EBM-o?B-B--oT----M-?o?ME??oMB?-B-oBB-EE---E--o--?---?EMBoEo--o???B-B--o-B-?M---B?ooM--oT-B--o-o-M?-o-o?-E---MB-E-M-------?---?--B---o-oB-oEoMo?-MM---B--?--B?-B-Bo-?M-o-BM------M--?M-o---EE--B-EM-?ofoo
--M-M-MoTo--|-?o-MMMo--B-E-----M-TToM?M-M?M-B-ooo--o-M-?E-?---?oT-To--EBoB-T--B-o-B---?|T-?--BoM--B-??BMMB?-TB-?-T-?---EoB---Bo?M?TM--?--E----ME-EEo?-E--BooTBEMMB-----E---TME--?----?oB---B---o-?-T-foo
mM-BE-BE|-o-|oM?Eo?M??E-M?--oE?oM||ooBE----BEE?M-BooM?oo-?B?oBo-|-|--o-?-oo|B?ooo??BooM||----?EE-M--BMo-oBBB|oBEM|-oo-BB-E--B?Mo-o|MBBBME-MEo-?-B-?MMoM?-EE?|--EoB-?--BMBB-|MB--?-EEM?--E-M--?-BM-o|Bfoo
X----------------------------------------------------------------------------------------------------------------------------------------------------------------------------------------------------fXX
