------------------------------------------------BB------------------------------------------------------------------------------------------------------------------------------------------------------
---------------------------------------X----------------------------------------------------------------------------------------------------------------------------------------------------------------
------------------------------------------------------------B--------------------------------------------------------------------------------------------------X----------------------------------------
------T-------------------------------------------------------------------------------------------------------------------------------------------------------------------------------------------------
------|--------------------------------------------X-------------------------------------------------------------------------M--------------------------------------------------------------------------
------|--------------------------------------------------------------------------------------------------------------------------------??BBBBBBBB-----------------------------------------T-------------
------|-----------------------------------------------------------------------------------------------------------?------------------------------T-----------------------T----------------|-------------
------|-------------------------------------------------------------------?----------------????????----------------------------------------------|-----------------------|----------------|------------v
------|------------------------------------------------------------------BBB---------------------------------------------------------------------|-----------------------|----------------|------------f
------|----------------------------------------------------------------------------------------X---------------T---------------------------------|-----------------------|----------------|---T--------f
------|-----------------X--------------------------------------------X-------------------------XX--------------|---------------------------------|-----------------------|----------------|---|--------f
------|-----------------XX------------B-----------------------------XX-------------------------XXX-------------|---------------------------------|-----------------------|----------------|---|--------f
---o--|--o---o----------XXX---------------------------X------------XXX-------------------------XXXX------------|---------------------------------|-----------------------|----------------|---|--------f
--T---|-----------------XXXX---------------------------M----------XXXX--------------------?----XXXXX-----------|---------------------------------|-----------------------|----------------|---|--------f
m-|---|-----------------XXXXX------------------------------------XXXXX---------------E--E------XXXXXX-------E--|------------o--------------------|----------E--------E---|------X---------|---|--------X
XX|XXX|XXXXXXXXXXXXXXXXXXXXXXXXXXXXXXXXXXXXXXXXXXXXXXXXXXXXXXXXXXXXXXXXXX---XXXXXXXXXXXXXXXXXXXXXXXXXX-------XX|XXXXXXXXXXXXXXXXXXXXXXXXXXXXXXXXX|XXXXXXXXXXXXXXXXXXXXXXX|XXXXXXXXXXXXXXXX|XXX|XXXXXXXoX
