----BBBBBBBB--------------------------------------------------------o--oB------?BBB????---------------?---------------------------------------------------M---------------------------------------------
---------------????--------------------------------------------------?---------XX--------?----------------------------------------X----X--------------X-----------------------------------------------M-
---XXXXXXXX-------M--------X-----------------------------M--------------------------------------------M---------------------------o----BBBB-------------------------------------------------------------
------------BT--o-?-------------------------------------XXXX----XT-----M------------BB------------------o-----?------------------X-?---T----o-----------------------------------------T-----------------
-------------|---T-MXT-------------------------------------------|----T--------X----------o---o--------------------------XX---XXX-B----|-T---------------M--------T-------------------|-----------------
----------?M-|---|---|XXXX---------------------------------------|----|-------XX--------T-TX--------------TB-------------------X--o---o|-|-------X----------------|-------------------|---------T---T---
---T---------|-T-|---|X---------------------B-----B---o----------|T---|-----TXXX-----X--|-|X-------T------|----------------B--XX-------|-|-------XX-XXX------T----|-------------------|--???X???|---|---
---|-----T--?|X|M|?--|XX----------------------?------------------||---|----T|XXX----XX-T|T|X-------|-o----|-----T-----------oXXXTX-B---|-|-------XXX--M------|---o|-------X-----------|-X---XX--|-T-|--v
---|-----|---|-|X|---|XXX----------------------------------------||---|----||XXX---XXXX||||XBBBB---|o-----|--T--|----X------XXXX|X-X---|-|-------XXXX--------|----|------XX------B----|XX---XXX-|-|-|--f
---|-----|---|-|X|XX-|XXXX-------------------X-----------------o?||?TX|?-XX||XXX--XXXX-||||X-------|-----X|--|--|?--XX-----XXXXX|X-XXX-|-|X-----?XXXXX??-----|----|-----XXX-------X---|XX---XXXX|-|-|--f
---|-----|---|-|X|X--|XXXXX-------------------------------o------||-|X|o-XX||XXX-XXXXXX||||X-----B-|-----X|??|--|-XXXXXXXBXXXXXX|X-XXXX|-|XX-----XXXXXX------|----|----XXXX------XX--X|XX-XXXXXT|-|-|--f
---|-X---|---|-|X|XX-|XXXXXX----X---------??---------------T-----||X|X|XXXX||XXXXXXXXXX||||X----X--|-X---X|X-|--|XXXXX--oXXXXXXX|X-XXXX|-|XXX----XXXXXXX-----|----|---XXXXX-----XXX-XX|XX---XXX||X|-|--f
---|-----|---|-|X|XXX|XXXXXXX---XX-------------------------|?X--X||X|X|XXXX||XXXXXXXXXX||||Xo---XX-|XX---X|XX|--|XXXXX--XXXXXXXX|TBXXXX|X|XXXX---XXXXXXXXX---|----|--XXXXXX----XXXXXXX|XX---XXX||X|-|--f
---|-----|---|-|X|XXX|XXXXTXXX--XXX--T---------------------|XX-XX||X|X|XXXX||XXXXXXXXXX||||X----XXX|XX---X|XX|--|XXXXX-XXXXXXXXX||XXXXX|X|XXXXT--XTXXXXXXX-o-|-M--|-XXXXXXX---XXXXXXXX|XX---XXX||X|X|--f
m--|-----|-EE|-|X|XXX|XXXX|XXXX-XXXX-|?---------o-E--M-E---|XXXXX||X|X|XXXX||XXXXXXXXXX||||Xo---XXX|XX-E-X|XX|XX|XXXXXXXXXXXXXXX||XXXXX|X|XXXX|X-X|XXXXXXXX--|---X|XXXXXXXX-XXXXXXXXXX|XX---XXX||X|X|--X
XXX|XXXXX|---|-|X|XXX|XXXX|XXXXXXXXXX|XXXXXXXXXXXXXXXXXX--X|XXXXX||X|X|XXXX||XXXXXXXXXX||||X---MXXX|XXXXXX|XX|XX|XXXXXXXXXXXXXXX||XXXXX|X|XXXX|XXX|XXXXXXXXXX|XXXX|XXXXXXXXXXXXXXXXXXX|XX---XXX||X|X|X-X
