---?--Bo-?B??--?-?-M-o---?--M---?ME?B----MB-B--Mo?--E-MEMEB-?Bo---?---E-o----M--o--o-o-M--o--o?-E----M-B----B-B?MM--?Eo-?---??E---B-B-M??---EB?-?----ooo---oMMoB--oo-MEM---EEM-?MMM-M------?E--oMo----oo
M?E-M-B--Mo-?o?---E-Eoo--oEB-BMM?M--?M---o-B?-------M-??-?MMo--o?-M-MEB---o--oM---?---?E--MEMM-E?M--M-B-Bo-B----M-?B--MB?-?B-M-oB?--?-?oEM------ME-o-?BEE--?-----B--Mo-M---?M--o-B-o--E---M??oMB-o-oE-oo
-------E?-o??M---B--?BoE-B--EBMM-EoM--------------o-MBE-EMB-o-?--?MEoM?-EM-?----o?B--BB-B?oMB--MM--?M-----oE--MM--Moo?--MB?o-M-E-?-?M--o?E?o--?BBBEBo-M-?M--ME-----o-o---M-BEoBo-o?-oo?-Bo-ooM-?--o---oo
--BEBB??-B--?EB-ME--?--M-E-M-MBM--oMM--B--M-??----oMo-??B---EBB----M-B-EM-BBB--o?-?--BB??E?o-M-----ME-E-Bo-M--oE?-MB-BB?o?-B---?o-?EB-?B-?Eo--oM?o----o-o-E?M--BoB-BMEo?o----B-o-BE----MMo--E--E?--MB-oo
o--?MM-Eo---M?----M-o-E-M??M-?o---MB----oB----?E-M---oM--E-E?---------B--B?--?M?B-o-MMMoBM------Eo---M--------??----E??o-oE-MB--MM?-B?B???--------B-E--?M--o-----BE--?-??-E-oo-MB--o----o---Bo-B-?--M-oo
--E-M-E?EE-oBEoEo-BB-E?--?--EBEBoB-M--oo---M-?-M--M----M---MB--oo--MM-?o-o-----EM---oM--o--E-??B?BME--o-M-BM-M-Bo-B--E--?o--BB-Bo-o--B-----?--?Mo-o-B-BM--oo-B-B--M--B-EEE-B--B--BB-M--oB-MEMM---B?-B-oo
-o?E--BoMB-??MB-?E---M-MEMM--M?-M?---o-?MM-MM-E-M--o-B??--oBB-EBE-EBEBMBM-oEBBEM?o-EB--EEBB-----MBoMM?-M-EB--o-M-M-ME?--B?-o--M-B?o-?--BoB--?o--??Mo-----BB?---MEE---?EMBB-----?----B?B-B-M?E??E-?EMB-oo
-MoBB--M-oo--Bo-B--ooB--?B--?-M-M?-M?BoMMM-B?-B---oBo--B-BoE?-Mo-----E-----M--BoE--BBM--M-?Eo--BM-E---B--?---EB-BBM-B--B?-o--M?B---oM?oB?-o?M?-M?-?o-oE-E-EBB-o-MB--oBB-MEE?----M-o-M--oBoE-M--M--B-?voo
-?--E?--o-M--MMM--?EoB---?-Bo--oM-oBEB--?---?B--B?B-BM?o---?---B-BE?-?----??---?--oE-EM?-oEBEBM--?B-B------B?B-?E----B?--M?-?oo---oE-o--B??o--M-oo---M-E-----E-B---MMBo-EBM-?o--M--M?oBM-EB---E?-ME?-foo
--oE----MEM-B----M---M-B-E--??--?-M?-Bo-----B?-o--ooE----M--??-oo-?-M?EB-M-oo---o--?-M?Bo---M---MooMB----B--MBB--o?------E-??-o-M-MMB?-MMo------o-E?o-BM-?o???EooM---BB?-oBo?BM-o------MMM?-----?oMMMfoo
MMEBMMM?-M--oB--?---o-E-BMM-?oEo?---??B-M--?----o-Bo?-EBBE--B----o?M-oM--E-o---??E?-BM-BE--E-oo-B?--?--MM?Moo-oM?---M----M-B-E?-o--MB--E----EoE-B??B?oB?----?MMBo---E--o-?B-B-M--B---?B?oE-M------?oMfoo
?-Bo---B-?-BMEBoM-?-M-M-o?---B?-o?-BB-M?---o-?BMBoo?BM?--?--???M--Eoo-oM-M------?---M?-M?--B-E--BM--?oM--E?B-o--B?----MB-o-M-B-o-BBoBBB-M--M-BM----?-M?o-B--o--M-?-??-?Mo-Mo-o-M---?MB---?EB-o-ME--MMfoo
-?o?MT-TMMBo--?-oBo-o---E--o-o-B?-o---E----B---B?-B-M--E?-o--B??-----o--E-B-?MEoB--o?B--E?o-------E--Mo-B-MMo--B--B--E---??-?--B---oM--MB-?E---?--oMME-MBEMEM--Eo-B?-E--Bo-E-MMB?E-??-oBB?--?E-o-BBoofoo
---B-|M|TBoM-----To---oo?---M--??T--MoT-M-EE---M-B-?--TT--M-MB------E?-MMB--M?B-B-?T-ooMMBBMBo?---T-M---?-?T?o-B--M?-?TM---?o-?MT---M-E-B?EMMEMBB-TE-M--MBEM--o?M-B--M??-T-?-B-?B-BMT--??-?Mo--o-oBB-foo
mo-B-|B||?-?BE?-E|EB-oo?-oE--BB-?|-oB?|Eo??-?E---EE-?-||EM--?BE-o-ooBo---MEB??-o---|EoEBo-MM-M-M-E|-ooE-?M?|M?M--B-B--|?o--?-o?o|-?-M-B--o-E--?--E|-o--BME?-B?M?---?-M-ME|-MM-B-?B?E|--E--B?oE---BE-ofoo
XXXXXXXXXXXXXXXXXXXXXXXXXXXXXXXXXXXXXXXXXXXXXXXXXXXXXXXXXXXXXXXXXXXXXXXXXXXXXXXXXXXXXXXXXXXXXXXXXXXXXXXXXXXXXXXXXXXXXXXXXXXXXXXXXXXXXXXXXXXXXXXXXXXXXXXXXXXXXXXXXXXXXXXXXXXXXXXXXXXXXXXXXXXXXXXXXXXXXfXX
