?-?-Moo-ME?--MME---EEE???--?M?o-?-oBMoB-BEB---oM-----o-BM---?o?--E-M-M-oMMMB??BBB-oM--Bo-M-?M?-oooBE-M-?EB-E?o-B?--B--oM--E--B?-B----B-o-o--Eo---EE------B-oM-M-?EBB--B-B--?---BoME-Boo-B-?-Mo?E---BM-oo
B---o?oM--oE--?B---M-M--oB-B-M-o---B-o-o?BMoB-----MBBo--?---M-M-??oMBME-o-oM-o?-Mo-BB-M-B-o--BEB----oM??---?ooM--oB-o-BM-?B---o??M----B----oM--o-M??-?-BM?-MoooMM------?-EoE--B---?-MoB--?----M-??o---oo
-o-----E-ooB-----Mo--?--?B--M-EM---M-BM--??E?--o-o-MM-M-?B?B----?--E---o---oo--EE??--B-o----B----?--MMM---------E-M?-----o---E-EB--oo-BoE----o-M?o--oMo----?-BME-?oo-oM-M-----??-Mo-M-E-MB---B--MBBMo-oo
--B-E-oMoM-?-EoB--Bo---E-M?MMo?-M?oE-?-B---M-B-B----?M?M-oB----?o??--M?M-oB?EMMB?B--BB-?M------E--?--M-BEBMoo?--?o-B-o-o?-?-B----B-MME-E?oEB--?-----EB-E?E--o--?---Bo-B---MM-o?--MMME-BM?---M-?-------oo
?BB----MBo--BBMM---o-?o-MMMMBMoMo----M-?--?-ME--EoBEE-o--E-o-o----MB?E?--o-BMEBoo-M--B-oB---E-M-E-M-E-o-M?-E--BoMBo-?-Bo?--o?B--B-o--BM???M-B-B?-M-M----o-?-?---B-E---M-B-EMB?B----M?B-Eo---------M-M-oo
---Mo-?E-BoM----MM-?---?-B-MoE??---o-?o-o-M-o?B----B----M-oo?o-Eo-M?-Mo-o--MMBB-o??M-Moo-B--MEB--o-o?M-EM--M--o-o---M-------B?---EBM?----?--oM-M?-ooB?----BM----?---o--?-o-o-?-M-E-?-B--M---M--o--o??-oo
-?--o-EM---o??B-M-M--oE-E-BM-?---------?----B-EBM-?M--o--o---Mo---MEBM-oMB?M--?B??-?o?B----B---M-------MBB-E-o--M-M--oB---M?M-o-MBB?-MMoM??o-?o-M----o---BB-oo?-M??-ME?--?-------B-M-M-B-oo?-B-----o--oo
-MM-o-M-B?BEBMo-E--B-BM--Eo--B?-B-?M-oB-oB-MooB---M--?----B--o-B-EM-BE??E-M?-M--MMM-E-o-Eo--Mo-M-oB?----??-BMEM-??----M--BoM-Eo?M-M?---oBB?MooEE--o-?oo---B-?-E??B-Mo--EE---B--?----M?---B?-E--?-?M-ovoo
--M-EMoB-B-?BM--B---E-oBo--?B---Bo?Mo---EM-o----o-?BM?-?oE------MME-B?M?--?MBo--Moo-B-B-MB-oE-oM-B-M---B?-MM????--o--B-MMB-o--M--M-B------B-oo-MB---B---B-?BM-?---?-o-o--o?---B-o-------B?---?M--MoE-foo
-?B--?-MM-----o--??-M---MB----------o--EBE--EBM--?ooo--BE-??M--E---?o-----EB-B?oo-M---E---o-?o-o?-o-B-MB-o---E--?--MB--E??E?--E--?o--oE---o-MM----------o-EB?-----?--M-o--?--E-ME?-?-oE?M---?oM-oBB-Bfoo
M--B---EE---E-o-o---BoE---B--o--?--?--?B---M?-BBEM-oB---?o------?-?BMEBE-o?MME-?o-M---M--oE?o?BM--B---M----oo---M-?o--B-B?M--M--M-?---B----B-----E-BM-o-BoB-?E---Eo--M--BMB?-M-M---E?M-E?----o-?---B?foo
-?--?oE?BB-o-----o-EBoBo-o-E-----M--?-MBM-?o--B-B--??MEB-M-o-B-oE-MB-?B??-oB?B--Bo--?-?-EM-M-oMo-MEB?-B-o-o-B---MBB-o-B-?-o---M--?-o-BoE-B-oM---MMM-M---B---B-o--B-?-o-E-B--?oB----BEM-?-E--?B--Mo-E-foo
?o---?B---o-M-B------M-o--?-?-?---o?-oBEM??EBEM-M-M?----M---M--E----oB--?-?-M?-MBMo-MoBoMM-B-B--E-?E?-B-o-??----M--?-?-BMooMBo--EoTEM-EMBM-M-o--B-oB?--MM------o----?-?-o-----MoM-Mo?o?M?M?-E-?EEo-?-foo
MoBB?--To-?--B-?B--MoT?B-T-oE?--MEBTMM?T-Mo?M???-o--T?-----EB-BToM?o-MTMMT?--oB--?--oB-Mo-Mo-M--TooM-oE-M-?BBo-BETo--M-TM---oo-MM-|-?E-TB--??EB?M-M-----oBE-BBB--o-?To-TBTB-----T?-ooTMBM-MT?-M------foo
mo-EoMM|-MBo-B-MB--BE|B-E|--B-??BB-|oo-|-BBBoMM--?E-|MoM??-M?--|B?E-E-|M-|-Mo-o-M---MBEBM--oE-o-|o--E----?EoEoE-B|M--B?|---E-EBM-o|M-B?|B?-B---?o-B-E--EB-?oM-B--EB-|M-|E|-E--M-|B-M-|BEME?|o-Mo??o??foo
XXXXXXXXXXXXXXXXXXXXXXXXXXXXXXXXXXXXXXXXXXXXXXXXXXXXXXXXXXXXXXXXXXXXXXXXXXXXXXXXXXXXXXXXXXXXXXXXXXXXXXXXXXXXXXXXXXXXXXXXXXXXXXXXXXXXXXXXXXXXXXXXXXXXXXXXXXXXXXXXXXXXXXXXXXXXXXXXXXXXXXXXXXXXXXXXXXXXXfXX
