--M?E-B?-M-?-o---M----o?o---------o----B-BBMB--?--Eo?-----oMB----o-?B-M--M-EEE?--MoEEE------B-?oEM-B-?--BM-E--?E-?oM?--oMM-??-?-?---MME---B--M--M?--o--B-E---Mo--??-E-?M?--M-Eo-BB?MMM----MEE-?o---oE-oo
o----------B--o?-M-oo-E-Eoo-EEB--Bo-oB-------?--MoMM-o?----o-M?--?---oEoM?-BM-o-B-??M?----?M-o--M-BEo?oMB------B?--o?--M-??o-B?M--B?B-M-o--M--?--E-?-oBM-?oM--?Bo-?-BE-o-?MoMBo-M--MEB-?oMM-M-?B----M-oo
-?-MBMM--o-MM---BBB-o--MBoBE?-BB-E?o--B-?---EB--EM---Moo------B?-B-?--?BE----B??B--EM------o-E-E------?EB-oo--BM-?-EB?-B---?-BM-M-MMo--??E-B--M-oMBM??-E-B---M?oB--?MM-MB??--?--ooE??---B--ME-E-M-----oo
-M----M-?-M-oMM-?-M--BBoo--?o-E-MMM-B--BMM-EB---Mo-------M--MB-?oo-oB-----B--oo---B?-o--B---oB-B---Bo?o??E--?-M-??E--BE--MM-B----E-BM---?M---o--B???----E-oMBBM-Mo--EB-EoMB-EEM----Mo-?---B------?B??-oo
o-o-?-EBB-M-B--?o-M-B-?--?-EoMBE-?o--M-ooMo?--EE?M--?-?M-o?oB--M--M?---B-oo-o?oB--?-EMB?M-E-E---Bo----?M--MM-?B-?-----Bo-B-B---o-?oM--?-?o-Moo------?--B---Bo-----E--?B?o?E-----B--B----B-o----BoEM?--oo
MMBE?o?BMoMB-oB-?-?o---???M--BBBE-?---E-?B-?-B?MB-B-?-B-----?BM--B-?---M-o?-o-?---E-?-oBB-B-M-EMMo-o--E---B---E--ME--?BB--??-??Eo-B-oM--B?BB---BM-B--M-o-?B---Bo----EE-oo-M-M?-?o?---B-oM--oB?E?----?-oo
o?oMM-o---?--?-?-oM-MM--B--MM?---oM----?B-E?--M--E-B---o--Bo--?o-?-oo-M-oo---MM--?-o--?-oB?B--B-E?--MMMME-?o-M-BE-B----E?--B-?-M??oMM-B--Bo--oo-?-?EE-o-?-E--o-oo---M?Mo-MM-ME-----E-----M---?----M?--oo
o------M-B-M-?-MEoo----E?B--?--MM---BoBM-MB?-o?BB--BE-M-ooo--EoEoE---E--o--?-oBoM-M------MBo-?--MoM-BoMB?oB-?----BMo--M----?-o-M-??o?M?-M?B?-BoM--B-M-EEB-B----E-??o--?o----?----E-M-o---B-EB?ME?E---voo
M-M-B--B---M-ME-M---------o--o?B?--M-?-E-?-??----?o-??-?-?-E--?B-?o-?-----o--o---oMooM---M-?BE--?B-?B-ooB--B-BMMB-M?-M?-ME-o---MMB-B---oM--?oE-EMB?-M-B---?-?---oMM-B-?---o-B---o--o---B-M-B--??-B-Bofoo
M---E----?-EoM--o--Bo--BM-?MBo--EE-?----oM--M-M--?-o-o-B?Eo-?EB-MM?M-E---MM-o--oE-B----EB-M--?------M-Eo--??o-E--?---o?MM---MM?-?--BMB-o-------?E-----?-o-o-E-M-----Bo-B-E???o-----EE---M-B---o---EBBfoo
-?-MB---M--?-o-M-MME-o---EMMo?B--?--?---EBBo---??-ooo-o-oM-B-BB-o?-?-MoooEM----B--??--?-B----o---?---MM-o?-?----M-E--M-B----o-?---B-?oo--MMB-M-oMo-oooB?o-E---MEB-oM-----MBBEMEoE-MM?Eo---------Eo-B-foo
-o-oB--oo-BoMB-----B----E--M--?ooM---EB-?M-M-E-B-Mo-Bo---o-Boo-?M---E---BBo-------M?o--E--Mo----?--MoM--oMB?M---MM-o------M-?MM-E-E-o-B-oBE?MMo---??Bo-oo??-?-o-?-----?---M---?M-?---M-?--?---Bo-E-Mofoo
-B-?---Mo?---o--B?Bo----Moo?--E-M-M?--BM-?--?M?--?--oBBM-oo--o-BEMEM-EB-???-Bo--?B-----Bo?--oB?-Mo-BMMBo-o--------?--M-?--E-B-M-??Mo---M?-BB-?o-Mo---B----o--E?E-M-M---ME---E--BBM--??-B-MME-B--M--oofoo
-oBo?ooETTMoo-----EB-?BE-To-----------oo----E-o---TooE----M--?M-B-TB---E---T-ETT-o-B--oTo---oEoMT-oT?-To?-BE--MT-B-E?--?E?-BBM?o--EBE-?--EBM--E?METMBB-M-B-?--BM?-MM-?MMT--?TBEMM-B-T-B--BMT------??Tfoo
m?EEooo-||M?-B?BME--EBB?E|B-BBMo-E-EEoB?EBoE-MB---|?-MM-?-B-ME?M-M|M?-B---?|BM||BM---oE|?Mo-BB--|--|MM|EE-o---B|??-?--oBM?-?E-oE--?MB?-MB--B--B-B-|o-MB-E-BMoE-BMoo--MEM|?--|EB-BE?E|B?M?-E|-MME--oo|foo
XXXXXXXXXXXXXXXXXXXXXXXXXXXXXXXXXXXXXXXXXXXXXXXXXXXXXXXXXXXXXXXXXXXXXXXXXXXXXXXXXXXXXXXXXXXXXXXXXXXXXXXXXXXXXXXXXXXXXXXXXXXXXXXXXXXXXXXXXXXXXXXXXXXXXXXXXXXXXXXXXXXXXXXXXXXXXXXXXXXXXXXXXXXXXXXXXXXXXfXX
