MMMoo?--o--BMEMoBo--BE--B-E?----Bo-?o--oM----B----M-BE-?--?-?-o-B--?B?MBo?o?M-B--EBM-MM-oMoo---MM--E?M--o?-----?Bo-o?---E??B--M-??--o?---E-M--o--BE---B--M?B------o?--o?-M-EB---?--E--BBB-Mo----??-oo-oo
-?EBE--o-------oE-B-MB----M-E---B----E-?oMBE-o-E?---oB--M---E--??-oE--E-M--M--?--M---E-MM-o---E-?---??--E---ME-?---ME--MB-?-M---Mo---Bo-M-M---MBB--------BM--Moo-MBBBoM-B----?---M-?-?-B-?---M-?--B---oo
E-B-?MoE--------B?-??--o-oM--M-B-?--BB-M--------o---o--Mo--B------B---BBB--o-EMBM?-E------M---B--B-B-BM-?----M----B??o--?-???B-o-??----?E?o---Eo-----B--EMoM?o?--M---o-M-E?B--ooBMM-o---E?-B---E----B-oo
M?-o--o?-E?---E-?MMo---?o--o-MB-B--o--Mo-M--M-?-EE?B---B------o-MMMo-oM-?o------?BoM-E-oMo--o-B-B-M?--M-M?-BoBM-oBM-MMoB-oM---E---o-M-M-BE-----M-MMMB---MoM-?EM-----?-Bo--B---?-M-?-oE--ME--E----o----oo
MB--o-E-?--o-oBo--M-E-----BB-Boo----E-B?--o-o--o-B?-M--?Bo-M-?E-?--oB-B----oB---ooMoE-M-B-?-o--?E-M---E---?B-B--o--o--B-?BE--o?-----?o-EM?o?o-o??-?-----oM--EB??-o--E-M--o?-------?EM?-o?-B--oE-Boo---oo
-Boo---?-M------MB--M-BoE---EB-----B?--B?-M--?--oo----oo--oo--B-o-B------BM-EoBB----M-MBB--EMBEoME-o----B-EB--M------M--B--MB----oB---B----Mo--M-BE-B----E---BM?-BEoM-M?------Bo--?-?E?E-M----?-EM--o-oo
M-o--?--?Mo--BE-M-B-Mo--??-BBM--BE?M---o-oo-Eo?-M?-----M-E-o--?-M-?-o?-E-E--B?EM--EMB-M--B---MB?E?-B-E----B-MB----B-o-MB-MM?M--EoE-?-o?-M-BMMo-?MBM?--MB-?oB?--MB-?--oMB---?-M??-?M-E-???-o-o-EM-M-E?-oo
oo-ooMBB------B?M---o-oM---B--M-M-M-E?o-MB-o--?---?---?EMM--MEo-B--B--?Bo---BM?E--?Bo-MEM?E---M-----E-o--E----ooooMB?---oBMM?---MM---MEMoM-EoBB-E-EB-oB----M--?Bo-?-BB--E---oB---MB-M-E--Eoo?E-?--B?-voo
----M---o-E?-?M--B-E?-oB--?-?B-oME-M-o-E?--Mo?------o----BMo-M-MBMM-E-EB-MMoEME---?-oMM--BB----Bo------MB--?M-BB-B?-M-BM-o-E--B-E-EM?-----M-M?BE--Mo-?M?-ME-E-?-?-B-M-o-BB??-oME-??o---?-Mo------o-o-foo
-oo-Bo-??BM?M?-MB-o----?M--??--B-?o--E-B-B-MBEM----?-?---MB---?--o--M-B---?BM------M-oEME?---o--MB-o-M-o--o-o--M?-ME---M-Mo-?-o?M-----BoEo-oE-E-E--Mo---E-Bo?--M-E---MM-M-EM--??E-MMMEM--B-EB--MBE--Mfoo
?-?--M-M-MM-o--?----B?-oE?o?M--M-o--o-?-M-?-?-o---B-?--?E?BB?--MEE-MB--o?B-?BoB-M-EM??B----E-----?B--MoMEE?o--M-Bo-B-----EBo-oB-?B-----MBM-B--MoM----oo--B?BM?--------?---B--M-E-E----E-Bo-M--o-oMoB-foo
M---E--B-o---E-?o?-?BB--MBMB---?--?B-?-M--?-EBMMB---M----M?--?BM-?EEB?-?--B-EM-MEoM--oBE--o-MEo-oo--EM??-M--Moo-M---?EB--M------?EB?-o-----M?--B--E-o--MM----EE----EMM--o-o--E--MM-E?------M---EB??M-foo
----T-?o--?-M--o-T-M---B-MM---M?E-MB---o--M---?--B------MEBM?Bo?--B---oM?o?-?-oMB-Bo?-B-M??oMM-B---T-MM?---T-MEB-?o-oB--oBoMoE----MoB-o?-M---oo---M-oTo?---B??----o-M?oB-----ME--?MMoo-o--E----?M-?-Bfoo
-ET-|EoE-To?To-M-|M?TB---?-BM--oTTBBMM-MTo?-TT-B?-TBT---BBB?-o??-MTB?ooT?MT-?--EE-?--??ToEToooBBMMM|EBMoT-T|---T-?--?oB-BE-?E?Mo-?--TT--o-TT---EB--T-|ET-B-MM-o-BE---TT--?--?-B?o-E------T--M?o--o--ofoo
m-|E|M?BB|-B|M-E?|BM|oBBMB?-?-E-||--oM?E|?-E||----|E|Eo----?MB?-B-|E?--|oE|--oEM--M----|M-|-oMMBEE-|-?-B|-||Eo-|-B--?EE--MBBM-E-B---||---B||-E-B?--|-|B|E-MB-Eo---o-M||-----Bo-M-E-BE??-o|Bo-BoBEEBE-foo
XXXXXXXXXXXXXXXXXXXXXXXXXXXXXXXXXXXXXXXXXXXXXXXXXXXXXXXXXXXXXXXXXXXXXXXXXXXXXXXXXXXXXXXXXXXXXXXXXXXXXXXXXXXXXXXXXXXXXXXXXXXXXXXXXXXXXXXXXXXXXXXXXXXXXXXXXXXXXXXXXXXXXXXXXXXXXXXXXXXXXXXXXXXXXXXXXXXXXfXX
