MBB-?-oBo?--EM-oM?--M-?---B---M-?--E?--M-?E-o-B-o?BB-M---?--o---EMM?oo--B-ME--M-----E-o----B-M---o-oo-----EM?-M--o-M-o-?EB-?--oB----B----M-B-Mo?-M--M?BM-o?-M-oo-----B--?o----o--o-EBMo-?-M-E-E?------oo
o?-oB-M---M---o-?-?oB-o-o-MM--?-?E-M-E---o---E-oMBM-B?-o--B-E--?BE??E-EB?-EM--BB----?-M--?EBoME-o---B----BM?B-B-o-------??M-o---MooB---BoM-o-MBBoB?BBB-M-M---o---o?-B--?---?-E---E-M--B-M----oBE?-E---oo
o--?-?---o-M-?-oEM??o--?--oMoBMMoBooM?-o--o-EB--?M-B---?----M-EME?B?M-----Bo-o---?o-M-B----M-??---o-M?-ME---E?-M?o--o-MM-o?-BE-E--?----------M--M-M---oMo?M-?E-B-B-M--?-o-o?oB-B--?---MB?--?MBB-----o-oo
B-?B-B--Moo----MMBM----MMME?----EME-B-BEEoB--?M-?o?BoBB---BBMB-o-MM-----M-?-BE-?--BB-o---M-?o---o?BM--?-?M--MMBE--?--B?-o-?M---?E?BMBE-?-o--o-----o-B--oo-B?-?-M--?---oM-E-MM---oM-?M--o?-E-?B?---M-M-oo
-----M---M?--B---E-B-?-E--BB-E---M-?----B-o---B-EoM-o-M-B-B-B--?o-M-E-o--?--MB?--EMo-?-o-EBB-B-oEo--oEB--o?M-o-MB?M--?-?M-Mo----BoBo-BBM?----o-MM--oBB-?B-?o---MM-o-MB-M----EB----MEEBoo-?M??Bo-o?--M-oo
--??-EBMo-B?MM--M??-M?---oE--B?--M--Bo-B-Mo--o???M-------M-E-----M??-E-?-o-B?-o-?-B--??-?Mo?-?B--B----?---B-o?--ME-MM-?E-Eo-----MB?-B-B------MEB-oM--EB?Mo-M-?oMoE-M---o-B-?--o--M--M--ME---ooM---EEE-oo
o?-?o?---MM--E-o--BM-?--?-ME-MM-?-?BE?-?oEM--?M---E---B-o---B-E--o?EB-?-?MMM----ooo?MEoM?-o-MM-B?B-?-o-ooBE---o-?----M----Bo-o-M-??-BoE?--?--E--MM-B-???---o----?B-Bo-BBE---Eo?---o--B--Bo-oB?----MM?-oo
----o--E-Bo--BBB-----MMB--B--B?----o----MB-E?Eo-o???o-??------B-?-oB?--MBM----------o-B-BoMo---E--o-o--oMM----E?B--E---M--M-M-M--Bo-o--EMoo--B-E-E--M--??ME-?-o-MM-B----?-?E-?-?-EB--?-BE?-?---?-oE?ovoo
oB-oMM-BBE?-Mo-BBMEM----??B-?-Moo--?-E---M--BB--oEo?EEo-o?-o-ooE-----Bo-E?--MB?o-B----o--?B-M-MB-B-EMoBBB-M---?-E---o--E---?-?Boo----?-M-?---o-MMM----?---?oMo----?--Mo-MM?--E-M-M?MMMB--BMEo-??BBB--foo
Moo-?-M?-M--?-?-oMBM??--M?--M-E-MBB-oBE--M--??E--M-??-?--Mo-BM?M-E-oE----?-?EMBo-??-ooB?-EE-?---BEM?-?--B-----M-?-o--E-ME--M-?---o?MM--oBB--B-B-----MoM---?B-BBoB----MMB--B-?-MBB-B--o?-E--B?o-oM?Bo-foo
--?-BE-?-o----BB------M?-?---oM--B-?-o--oM-ME-BMo----ME---B-MMoMoM---oB-o--?----B??B---B-M-BME?-o-ooEB----oo-M??----M-?-?-?B--MoM--o-o-?o--E--EME---?----?o---BM---M-------M-E-----M-oo-?--oM?M------foo
?MMMoM--M---E-B??B--o----M-?M--B-EE?-MB----MM-----?--o-?-B-?E-o-??--B---B---??-M----oMBE-MMBM??-M-B-M-o---oMBE--o-M---Boo?o-M-?E------?B--B--oMEB?-B----o-o---E-?EMM?M-----o---o----oB---?B-o-B----Mofoo
--o-?-MM--ME?o---B??--B---BB-B---BB---M--E-E-E--M--oM-MM-oE--M--B--EEoE--oooM-M?-o?B----oM?Eo--M?-BMM-o----o-B-MoBEBoo--oo--B--TToBM--M---M----M?B-B?-B-ME-o--B-EB-?-o?-?-M-o-?B-??--M?-?o-M-ME--Mo-Mfoo
-?-oB-o-B-B?oooMTo?-o-MM--E---T----M-TMM-BEB-Mo?-oEMEBTE----T---o--?B-T-M---T---o-T??-?oBE-BM-?o-BBEToE--T-BMo--M-?----?-oo?MBB||?M-o--?---?-M-E-BT?MB-BMM-TM--?T---?-----MMBEo--?B?oMoo-EoM-B-MTo?-Mfoo
moMB-oB---E----o|?o-BM?o-MB-E-|-?-M-?|Bo-EB??-?MoEBM?-|BM-Bo|-Eo?---BM|?E?EE|o-BBB|o?MEE?-o?E-BBoB-B|BB-B|EoB-MBoMM?--oo-BM?Bo-||o-o--o?EM-B-B?-oM|?B--EE-B|-B-?|---?BEB-M-?o?MMEM?M---B-BEEBoEo|o?B-foo
XXXXXXXXXXXXXXXXXXXXXXXXXXXXXXXXXXXXXXXXXXXXXXXXXXXXXXXXXXXXXXXXXXXXXXXXXXXXXXXXXXXXXXXXXXXXXXXXXXXXXXXXXXXXXXXXXXXXXXXXXXXXXXXXXXXXXXXXXXXXXXXXXXXXXXXXXXXXXXXXXXXXXXXXXXXXXXXXXXXXXXXXXXXXXXXXXXXXXfXX
