o-B-B-BBE-?o?--Mo-oMo--o-----EEE?E-?---BMM---oBoME--oo?BB?M-M---BME?o--------M-?-B?-EME--B---M-MoB--M--o--M--B?o-M--o---M-M---?----EMB-BM-oB-?o-M?-o?-MMB?o--M--oM-oB-----oo--M?--?E--BoE--o?E?---?-M-oo
-?----?-B-ME---MM-Bo?oM-o-?-MBB---?-M-??B----M-BMMEM-E-E-E--M--E?oBME-E--MBM---E-o?-?E?--MB--Bo?oMo-M--Mo--E-?B-oE?-----oBE-BoM---MM---EBo--oM--M--BM-B-BB--M-MM--E-EME--B--E--o-------BMB-??B---oMMo-oo
---E--M--B---M-B--?BBo--Eo------o-EM--M---BoB-oB-?-E??-?B?B-MB----M??-?-?-EB--?B-?oMo?--E-?---E------?E--BoB-M--oM--MB-B??M-?E-E-oM-B?-?-oEM--oE-?B?B---oE?M--o-B--EB--------B------oMM--B-Eo-B--M-?--oo
oooMM?E-----oBo---o-oB--?B----B?-E??B-o-E--?--Mo---B?o?--M-?B--BM---o-B-B--oo-Eo-MoE--BB-B--EB?Bo?-B--MBo-EoMo--o-?----o-E-----BB--?--E-o----?o---B--M-B---oEB-E-?-B-?----Eo?o---o---M-o-oB-oE----?-?-oo
-EM?E-M-E?E-M?-E----o--E??o---?oMMo----EM---MM---ooB-oB-M---oo--M--EoM?M-EE-E--M-?o?-BMB--EB---BE-B--B-o?BM--o-?o-o-o---BB--Eo----oM----B?o-M--B---B--oo-BB---M----MMo---?M---MM-oM--Bo?-?MoM--Eo?EMo-oo
BMM-M-o-?o-?--E-M------?--M-BM---?B-B-BMEEBEoE-ooBEo--ME-oMo---?-BBM--MBEMM-B-M---?-M--oMM--B-M-B-M-B-MM?oBoM---?-o---M-B-oo-o-o----M-M---M---EMB--oo--B---B--MB-E----------Moo--?M-M-BB-EM--Mo?---E--oo
M--M---E?-?Bo-M?M------B-B--oo-ooB-o?M?-?-?-oB-?----B----?E--BEM-ME--E----B--??-oM-Eo-BM--Eo--B-----?o-BBoBB?M----M-Bo--M-MBM-----o-?o-----B--MB-E-EM-B---?---E-BBM-?oE----oB--E?-Bo-o---?--B?B--E----oo
?M?M---M?-oBM-E-MooE---BEMEEMEM----???--o-Boo--o-?BB?-B--EB-o-MMoo?M--?--o-MoM-????B?oBM--MM--B-----B-EEE?o-?Bo?-?BoM-B----oE-M-oEE-?-E--oB-M-oM-BM-MB-?----oEME?o-oBMM---o?BM-M--E-?---B-E--BB--M-o-voo
-?----EBE-BooEBBo--B-M---oM-MM-EM--M--o---EB-E?-?-o-?oMM-MB-?-?BB?--o------EE?EoB--oo--B-o-------o--MM-?BB-BM--o--B-ooBE---MB?Bo-MMM-M-oE----oM----Mo--MM-EoM-MBE----EB?--oo?-EBE-B-M--?oBMM-o-------foo
-MMBMBME-B---B-?B-?--o----Bo-?-M-o-?-oE--B--?-MB----MB--MB-B-o-oB---oM----BM--M-Mo?o--o-----o----?o--B?------?--BE----?-BM--EBo-BB-MM---BMBoB?--M-MBBE-----o---?--oEMM---B---EBoBEB--oB-?MBo--B---?o-foo
o-M--M-?-?o?--MEEE--?E-?-o-B?-o-o-BM-oB-B-Boo?-o--Bo-??ooM--?o-o---?-??-o?-MMB-oMo-MoMMo-B?-?--BB-M--o-o-B?o------MooMo-?-MoMMM--MB?o-M??oEEM-Bo??B?B-B?--MMo-??-o-Bo---BoME--?--?o-ME---o?------MM--foo
BBE-B-E-M--B-BM---?-MMo----B-M-EE-BEE----MB--B----o?-Bo--oB-E-o?--------E----EMEM-Bo-M--?-B?-B--?--oB?oBM-M--o-o----M----?-Mo-B-?BEoMMo?-E???MM-B-----o--?----EB-M-M-?----?-M-?MMoM--M-M-B---o-?-E-M-foo
B-?-E-M-oEE?M-M-BTE---M?B--MBE-?MMMMM---o-oTBBB--BoM-oMB--?--T-oBMEo?--B?-?M--M-?o-??oM--oE----E-E-o--E-M--E--M-MBEEBM--o-----EMBM-M---?-?-?M?--o----B-?EE-BE-B-B--------BEBE--?BE-?--M--B--BooBo-Moofoo
---MM--E--?-M-B?T|-EB--M-o--MToMT--M--o-?E-|-M-B?M--Eo-oo-B-M|-?T-M-EE-B---BoT?T-?-oo-TMB-T----T---o---ooooT-?Mo-?T--?--ETEEE-?M?-M----?M----M--E----T--T?-TBo--TB-oE-o--B--TBBM-ME--T?-oM--T-BoM-?oEfoo
mo-o-M----oEE?-E||-B---E-B-Bo|-B|-EoM-BBM-?|o-?---?--MEo?MM-?|-E|o---B-E-B-M-|E|o--o?M|o--|BM--|BMBE-M-?-M-|BB--?o|-B?ME?|BBBo-oBBM-B---M-?-?ME-MMEM-|o-|E-|ME-o|EME-?BB-M--|o-o--?oB|--Mo-B|oM-??---foo
XXXXXXXXXXXXXXXXXXXXXXXXXXXXXXXXXXXXXXXXXXXXXXXXXXXXXXXXXXXXXXXXXXXXXXXXXXXXXXXXXXXXXXXXXXXXXXXXXXXXXXXXXXXXXXXXXXXXXXXXXXXXXXXXXXXXXXXXXXXXXXXXXXXXXXXXXXXXXXXXXXXXXXXXXXXXXXXXXXXXXXXXXXXXXXXXXXXXXfXX
