-------------M-B----------------------------------------------------------------------------------------------------------------------------BBBBBBBB-------------------------------------------M--------
-------------------B-------------------------------------------------------------------------------------------------------------------------------------------------------------------------------XX---
----------------X-M-------------------------------------------------------------------------------------------------------------------------------------------------------------------------------------
-------T-----------------------------------------------------------------------------------------------------------------------------------------------????---------------------------------------------
-----TM|-B-------T-M------------------------------------------------------------------------------------------------------------------------------------------------------------------------------------
-----|-|--?T--BXB|BBBB----------------------------------------------------------------------------------------------------------------------------------------------------------------------------------
-----|-|-X-|-----|--------------------------------------------------------------------------------------------------------------------------------------------------------------------------------------
-----|-|-TX|???XM|?-----------------------------------------------------------------------------------------------------------------------------------------X----------------------------------M--T----v
-----|-|-|X|---XX|------------------------------------------------------------------------------------------------------------------------------------------XX------------------------------------|----f
-----|-|-|X|X--XX|----------------------------------------------------------X-------------------------------------------------------------------------------XXX-----------------------------------|---Xf
-----|-|-|X|XX-XX|X--------------------------------------------------------XX-------------------------------------------------------------------M-----------XXXX----------------------------------|---Xf
-----|-|-|X|XXXXX|XX------------------------------------------------------XXX-------------------------------------------------------------------------------XXXXX--------------??????-------------|---Xf
--T--|-|-|X|XXXXX|XXX----------------------------------------------------XXXX-----------------------------------------------------------------------------oXXXXXXX-------------o------------------|---Xf
--|--|-|X|X|XXXXX|XXXX--------------------------------------------------XXXXX-----------------------------------------------------------------------------XXXXXXXXX--------M----------------------|---Xf
m-|--|-|-|X|XXXXX|XXXXX------------------------------------------------XXXXXX-------------------------------------------------------------------E------E-XXXXXXXXXXX-------------------E----------|--XXX
XX|XX|X|X|X|XXXXX|XXXXXXXXXXXXXXX-----XXXXXXXXXXXXXXXXXXXXXXXXXXXXXXXXXXXXXXXXXXXXXXXXXXXXXXXXXXXXXXXXXXXXXXXXXXXXXXXXXXXXXXXXXXXXXXXXXXXXXXXXXXXXXXXXXXXXXXXXXXXXXXXXXXXXXXXXXXXXXXX--o-------X--|-XXXX
