---------------------------------------------------------------------------------------------------------------------------------------------------------------o-------------------------?--------------
-------------M---------------------------------------------------------------------------------------------------------------------------B--------------------------------------------------------------
--------------------------------------------------------------------------------------------------------------------------------------------------------------------------------------------------------
------------------------------------------------------------------------------------------------------BBBBBBBB------------------------------------------------------------------------------------------
--------------------------------------------------------------------------------------------------------------------------------------------------------------------------------------------------------
---------------------------?----------------------------------------------------------------------------------------------------------------------------------------------------------------------------
----------------------------X-------------------------------------------------------------------------------T--------------------------o-----------------------------------------o----------------------
---BT----------------------XX---------------------------------------------------------?---------------------|-------------BBBB-----------------------M-------------------------------------------------v
----|---------------------XXX-------------------------------------------------------------------------------|--------------???--------------------------------------------------------------o----T-----f
----|------------XX--T---XXXX-------------------------------------------------------------------------------|----------------------------------------------------o----------------------------B--|----Xf
----|----------------|--XXXXX-------------------------------------------------------------------------------|-----------------------------------------------------X------------------------------|---XXf
----|----------------|-XXXXXX-------------------------------------------------------------------------------|----------------------------------?-----------------XX-------------------?---o------|--XXXf
----|----------------|XXXXXXXX------------------------------------------------------------------------------|---------------------------------------------------XXX------------------------------|-XXXXf
----|----------------|XXXXXXX---T---------------------------------------------------------------------------|-----------------------------------------M--------XXXX---------B--------------------|XXXXXf
m---|---------------X|XXXXXXX---|-----M----------------------E----------------------------------------------|---o------------------E--------------------------XXXXX------------------------------|XXXXXX
XXX-|-----XXXXXXXXXXX|XXXXXXXXXX|XXXXXX?XXXXXXXXXXXXXXXXXXXXXXXXXXXXXXXXXXXXXXXXXXXXX--XXXXXXXXXXXXXXXXXXXXX|XXXXXXXXXXXXXXXXXXXXX-----XXXXXXXXXXXXXXXXXXXXXXXXXXXXXXXXXXXXXX----------XXXXXXXXXX|XXXXXX
