E-EM?o-MB-M--ooo-?-o---BooM-E-B--oooB-o-o-oE-B---Eo--M--BBB--?-?----?M-ooB?-?-?-BBE--B??--B?-o--BB?--B--E-ME--BE-oM-MB---M?-EooM--M-oEo-B--??oo-?M?--E?--Bo?--?-----E-B--MMEB?o-BB-M--E?B--?BBo-------oo
M--E---Mo--BE--ME??o--E?-B--ME-B?-o-oM-M-M-?oo-E-oE?o-B--Mo-o-----o-o--MB?o-----EE-o??--M-?Eo--o--Bo?Bo-Mo-M---?-MB-?--o?---BMo-M--o-B----MBBM-Bo-M?--Mo-M---E--M-B?BM?oo-B?-BB--E--?o-M-oooBME??-o---oo
B--?B--?----M?-oM?--o??-??-?o---?M?M-MooM-BE?-??oMBBo-E??M-MMEM---MMMBM-MMB-B--?M---B?---M-M-M-?-o---oBoo-?--?-B?--oo---Bo--MBoM?-BBB?----------?BoMMo----o-MB?M-------?-BBM-B-E-Moo----?--M?oMBo---E-oo
BM--B-B-?-B--oE?-B?o-?--EEo-?-M?B-M---B--o--E-?-?-M--oB----o-B-o-Mo-o--Bo?----o-E?ooMB?o-Boo-EEoMB?M-----MM-?-?-M?E?M-?o-MBM---oBE-oBoo?MM?-MBB-B-?M-oEo-M-M-oo-M------BMEoM-oB?MBM--M??-oo?---oMo-BB-oo
Mo--?BMo--o-o----MMoE-?-M??-------Mo------?-------?--E-BoM--o-oo-oM-o-o-B??EM--o?-B?o--E--BM-M?oB--B-B---M??M--EBB---MM--BooBMMo-B-oB--o-??B-??E?-B-M--E?o-B?o?-?oB?M?---?-M?-M?BB----?M?----E?-o-ME?-oo
Bo--??--M-MM--?BE-B--BMB?-M-?-?-oo?Mo?--o-BBMoMEE-B-o----EM-M--oo?-?---M-?M-oo??-B-M-BE?-MM-o-B--M---?---M-BoM----MB?B?oEoB?BMMMo---MB-E-MMBEoBMBo---?o?-EB--?-oo-ooE--M-Mo?-ooo---o-M-?-Mo-o--M-o-MB-oo
oo?-?o?-M-Eo-M-EM-?ooB--E-B---oo-E--E--?Bo--M-MoM-M?------o-M------o----???E-MBM--o-oB-B--oM---?-Eoo--?B--o?M-?---?BMo-oBB---MMMBooooMM--MMM?-?--BMoB-Eo-M-oE--?--?-M-o-???-M-Boo-o-B------?-ooBB?--M-oo
-B?E-BoBo---MB-B--E--o--Mo?E-B--EM-EME----o-M?BoBo-B-?M-------BoBME-o-Eo?-E?E-o-oMooMM?BMB-MBE?oMMEo?-M---oEEE?---Eo-E--?-oE?EB?---oB-?B--M-?---?-B--o-?B--o-o?--BBo-oMMBo-EM?BooBB-ooM?MM-EE-M?oB?Movoo
-B---MM--?M--E-B--B-?ooEMM--o?Bo-----Mo--E-?M--Boo----?Moo-?Mo-B-o-Mo----?B--?-o--M--B----o-MM?B-oB--?--o---B-oo?-M--?-?B-B?M-oM---B-M-oo--?-?---B--?ooMBB-oEE-o-B---?-MMBM?B-Mo?-o--Mo-M?-M?oB---o-Efoo
-MB?--B?B-----M-B?---oEM-Mo-?MBMMMB--oBo???--?-o-o--o?o----o?---E-oo??o?--oE-?B-o-B-B--M---Mo-oo?BE-B-?---?-B?EE---Bo-ooB-E-MB-EB-oMB--M-Bo--MBM---?--oEoo-M--?--Boo-BMEB--?M-MBB?B?o-oE-?-o----MMBo?foo
-o-M-M-E-MEMB--B-?-EE?---?----BM-o-o----o?E-oo?M-B--Bo-MoM-B?-----B--oM----B--B-EM---o-oM?o-MBo--o-M-M?E--B-B-MMMM-?B?-B-?----o---oM----M--?-?ooBEo--B?-BMo----MB-??----BEMBBoEE?-BBBM--M-EoooE-B-o??foo
o--?-MB-BoM-------oBM-E-o?-?E-Mo-----oEoEoMEo?o-?M----oM?-MB--E---Eoo-----oo---?B----?--o-o-oEM?B-?-Eo-BoB---B-??B-o-BoMMo----?M-o?--?-?Eo-B-?E-o-o?EoMo-B?M-?-E--oo----EB-?MMB-B-?MBo-E?M-E--BoBBE?-foo
Bo----oB?MM-E?----E-?BMB?---?-??-oEM-BB?--o-M-o-?-oM---oooEE-BM--M-MMo--o-Bo-M--?-B?-o--M?ME-?-oB???--o?B--o-T-B?B--BoM?-B?BE--?MB?--o?o?o--TB-M?oB-MoM?--M-oM-BoMEoMBo---EoM--o--?-B-o-o---?-B?BE-M-foo
---MTo-B-------?--M?-MBB-oMoBMBBE-?------T---E----?-?Mo-T-B--BTT--MBoBTo-M?-?oT-oBTM-EM--o?M?----o---TTMM---B|MB--B-BMTTo-TTT-M??--o----BT-T|?-?Moo-??ME--??-BB-BBTooT----?--M?ET--o?--?-To--B-?o??Tofoo
mBB-|-o-o-M-BMMBEoB---o-M-?MBE-?B-EEBoo?-|B?-??B-EEBoM-B|ooo-M||-?o?-?|oo?EE-?|---|---oEE-oE?EMM?E--M||o-o--M|----?BoB||?B|||oM?--MB-B--?|M||-EM--BoMoE-?MMo?-EEEM|-M|oBM----EM-|oo-EME-o|?M-EoBB-?|Bfoo
XXXXXXXXXXXXXXXXXXXXXXXXXXXXXXXXXXXXXXXXXXXXXXXXXXXXXXXXXXXXXXXXXXXXXXXXXXXXXXXX--XXXXXXXXXXXXXXXXXXXXXXXXXXXXXXXXXXXXXXXXXXXXXXXXXXXXXXXXXXXXXXXXXXXXXXXXXXXXXXXXXoXXXXXXXXXXXXXXXXXXXXXXXXXXXXXXXXXfXX
