----------------------------------------------------------------------------------------------------------------X---------------------------------------------------------------------------------------
----------------------------------------------------------------?X---o-------------------o----------------------------------------------------------------------------------------------------------X---
-----------------------------------------------------------B---------------------------------------------??----------------------------------------------------------------------------------------o----
-------------------------------------------------------------------------------------o------------------------------------------------------------------------------------------------------------------
------------------------------------------------------------------------------------------o-----------BBBBB?---?-------------------------------------------------------------X--------------------------
-----------------------------------------------------------------------------M-----X--X---T----------------BX------------------------------------------------------X------------------------------------
----------------------------------------------------------------------------T------XX-----|---X----TBBBXBBTXX-----------------------------------------------------XX------------------------------------
----------------------------------------------------------------------------|-----MXXX-T-T|--------|-o----|XT--X-------------------------------------------------XXX-----------------------------------v
-------------------------------------------------?------------------------T-|-----oXXXX|-||X-------|---M-X|T|-XX------------------------------------------------XXXX-------------M---------------------f
---------------------------------------------------XXXX-------------------|-|----XXXXXX|-||--------|X---XX|||XXX-----------------------------------------------XXXXX-----------------------------------f
--------------------------------------------------------???????--------o--|-|------XXTX|X||------X-|X--XXX|||XXX----------------------------------------------XXXXXX-----------------------------------f
-------------------------------------------M------------------------------|-|------TX|X|X||BBBB-X-X|XXXXXX|||XXX---------------------?-----------------------XXXXXXX-----------------------------------f
-------------------------------------------------------------?--X---------|-|------|X|X|X||---B-TXX|XXXXXX|||XXX--------------------------------------------XXXXXXXX----------------BBBBBB-------------f
------------------------------------------------------------???XX---------|-|----T-|X|X|X||XT---|XX|XXXXXX|||XXX-------------------------------------------XXXXXXXXX----------------M------------------f
m---EE-----------------------E----------------------o---------XXX-E-------|-|----|-|X|X|X||X|X-X|XX|XXXXXX|||XXX--E--E------------------------------------XXXXXXXXXX------E--------------------------E-X
XXXXXXXXXXXXXXXXXXXXXXXoXXXXXXXXXXXXXXXXXXXXXXXXX-------XXXXXXXXXXXXXXXXXX|X|XXXX|X|X|X|X||X|XXX|XX|XXXXXX|||XXX--------XXXXXXXXXXXXXXXXXX-XXXXXXXX----XXXXXXXXXXXXXXXXXXXXXXXXXXXXXXXXXXXXXXXXXXXXXXXXX
