---------MBM-BB?-o-----BM-----------BM?-BB--E?B---oB--B-MBoMBMo--B??E-??-oBMo-?--M-BB-?M-B-Eo-----BB?MoB-MB--o-oM--M-B-E?--MMB-????-ooo-E-o?-o?E-M-B---B-BEM--B?-Bo-BB-?-o-BBBBM--E-B--o----B--M?---?-oo
--------E--Mo---B--E-?Mo-oEo-o-oo---o-?-----B--?o-?MBME-?E-?-M-----B-o?B-?o--??o---??oo-------BE---Mo---B-?-?E---M--?--B--?E-?-oM-BMME-??M---?E--E--?o-------?M---BBB-B?M----E??BBBoBE-M?EEM-----oB-o-oo
--------B?oBo-?-M-E-E?BE-MB----B---EB?-M--Bo-o--MM-M--MMo-?o--B-M---B-o---o-Mo-o--o?M-E--M-----Boo----B?--o-----MBBo-EBB-M-B-E--Eo--B---B--B-M?o-?oE----M----B-B?----BB?-EB--?o-?-??-?-Mo-M--E--BB--o-oo
-?------BoB-E-o-?--EB?E--B-?----M--??--Eoo-BM-E------o?MM--??---B-M--o---Bo---BB?E-oM-B---o--M?-M------B-o-oo-o-B---?---B---------ooo--o--ooE-----?B-M--M-M--o-B-B?----B-M?oEM?--o-o---EMBMEB-o-B?oM--oo
---------?--?MM-?-o-B-BBM-?M--ME?oM?-?B-E?M---M?-------M-MoB--E-?-BMB-?oE?-?-?MM-MMooo-----o--MBB-Bo--?--?B----?ooM-?-B-----o----E-MBo-M-Bo-MB------EMB----?M-----oo---EBBMB?M-?o-M--M-M?MBM-E?---B---oo
---------?--?--EoE?-o-M?-?B?o-B-o-B?oB-o--oE---B-?--?BBE--MM--M-?-M?-B-EM-M??oo--BMM---BM?---BM??-M?-?BM-B--EBE-M---M-Mo--Eo??--MBE-M?EoBMB--???----B--MM-o-Bo-oM?BB--o-?-??o--oMoB--?B-o-MM------?EE-oo
--------oB-E?-M---o--BEM-?M-------MME--oo-???-?---M-B??B?-oB-o-Eo-----E-EBoM-oo-B---oMoBE?o??B-----oooE----EB?M-MEBo-M-MoB--?BB---B----EMBBoo-E??E-M--MEEM?MM----ooBB-----EB-?Mo--?-?BM-B-?---B-?-----oo
------?----?------?oMo-o?-o--M?---?-M-o--?M--BoB---M--o---EE?B-MBM------BM?MB-o------o--MM?--Eo-BBEM-E------B---B--?--?-M?--?---B--EB--?-??-B-B--BMB---MM--B-?---o-?M---M-B-Eoo---EE-oo-M-??oE--oE-M-voo
--------o-o?o-E-BBo??--o?-?----o---B---BE---Bo?E-oBM-M-Eoo---??-oE?EB-??-?B--o--------B?Mo---?-------?----o---Eo-?-M?o-B-M-?--MBM-M-?MM--M-----o-o-BooEEo-------M-?-oME--B--B?--?B-?o-?--EMo-?-o-?-B-foo
------?-M-?M?M---EM---oBE-BBE?o---Bo-o-o?---o-o-B----o----MoB--?-?o-M-EMo?B---M--?---oE-----?-EMo?M--B----o-M-BMM------EoMMoMBB-M--oM?MoEo?BE-B----oBM?-M-?E--o-o--M---?BBoB-----BE--EE?-?--EB-BE-M?Mfoo
------------B--B??-----M?--M-?--BE--B-E-Mo-M-M?--?oB-Mo-o-o----MB-o-B--o--E-?-EoE--MM-MM-Mo-?-B-oMo--Mooo----o-?-M?BE-o----Mo?-B----oMo--B-E?-o-M-M----o-BE-B-o-oB-M?-MM-?oMoBM---?--??B-oo-?------?-foo
-----------M----?M-BooE-oo-M---M?B-oMEM-o-o--oMo--?----BMEMBB?E-M??BB-oM--?M-BBoB?Bo-B-E?-B-?--M--?---o-------o-o---?--EE----B------o-B-oB?---o--?-EEo-?-??EBo--M-M-?-o-MoT------oo-M--BM-E?o?-?o--o?foo
----------B---B-o?-Mo?---o--o----B--o-B---E-M----B-ME?---?B--EMo-E-T-M?--E--?--M--?T-?o-TBo-B-E--Eoo-EE--?---?E?oo----?BM--EEo-M---o?B?-B?-E-?EE----M?-----?----BEBM---MBo|--MMBB-MMM-?---B-?o----?--foo
-o---o--oo-B-o---T-M?-M--E-MBBTEo--T?-?E--?T?---Moo-T?TBEB??B---oMo|M--M-?--o-o-o-M|-?-o|T??-o-oB-M--B?M--o?Bo?--?M-ooBMB-?-?---MMET?-?-oTT?--T-oT-B-M-Mo-MBMT?M-ToToE?-Mo|?B---B---T-o-??B?TM---?---foo
m-------?---EoE?B|?-B?E-EMMo--|?ME?|MoB--MM|--oM-BE-|-|E-B?-?-EBBEE|Eo-----BB--E?--|?--M||--Eo--o----?EB--?-BBBM-M-E?-MEEB--oE--M-B|-M-E-||-BM|--|-B?--?M-oE?|E-o|-|-?MMB?|o-B--EM-E|-o-E-MB|oo---?-ofoo
X----------------------------------------------------------------------------------------------------------------------------------------------------------------------------------------------------fXX
