-Mo---B----?-E---B-M-----B?-----o-----o-oo?M-B?--B--?--M-B-??E----M-E---Bo?BEB-BBo?BE---oM?--M-ME-----?o--?-MBE-?oE--BoM-M?-B??--oB-MBBE--EE---?-EoM---E--?EB-?-M-B-?----?-B-M---B--?EBM???-oE?-o--BB-oB
-B----BMMBooo?--E-o--o---?--o--o--B-----?M-----B-M--B-B---?M???-E-------M-E??EoE-o?--o-?---BB?--?--B--MoE--oMB-MB--M------MMo-o?BEM?--?-M??-------M-B---MBo-B?--B-o--B-o-MM-MMM------BE--B---?----E-----
-o?oEE?-o--B--B-BM----B-Eo-o---BEo-Eo?E-o?E----?--Eo?-----oo-?EMM?B-o-?MEMB-E----?---o--??--?-o?-B--------?---E-----MM--?----B---B-----o--BoBM?-B----EE-o-oM-oMo--?---EM--?-M-EB?---EB--B-?EM--?--M--oBM
-Mo-M?oB-?oM?-oEM---ME--Moo-?M?--E-?-----E--BMo-M?M?-M-B??-E----?-B-M----E-?B-EBoMBM-B-o-BMoEMo-o-----?--B?M---?--B-?--MoE-oM-o?-----o--oM--o-M--M-?--Mo?-??-M--BoM-?-MB-BE-MBM---BMB-BM--M-M--oBMMM--MM
E-?---BBM?MM-EM?o-Mo--?o--MB--?M--B-M-oBE?M----?-E?MME--B-----M---E----B--o--M--M------M?--o-?---EEBo-o-o----E--B-?Moo-o?-E----BMEEoBMoM--M-o?-o---M-Mo----??---M--B-?EB--MEBM-EoMBME----B?Mo--Bo--MB-o-
-----M-oM-E----?M-?E--?-o?o--MM-B---B--?--M-----??---Mo--?-o--EBoE---B--?-BM-----EMB?MB--M-BE-o--BM-?oMoM?-M-B?B---M--Mo--Bo-BoM-BM--E-oo-o?B?o-M--oB-----?--MMoEM-?---B--E-M-------B--BE-E--E-o-?--M?Bo
BBMM--o-o-B?-------BBM---?B---o--M?o--?-?--M?B----?o---M-MEMEo-Eo--??M-B-o--o----M???--E---BM?----E---EB--?oBE-?M-M-o-o-M----?o-o?MBo--?B--M-E--o-o?-oEo?BEo-?M-MooB--?---B--MM--?o-BB--?B?B-B-o-M-o-BM-
--?-----o--??-o?--M--BB-M?E--E-B?-M---B?oo-M-o-B------o-oMB---M?M?--B--E?oM--E---Mo??MMB--?-E?-M-EB---B??M-EM-MBB--oo-Bo--B--B------o---?o--o---?BoBE-MEM----?-MM-M-oM--E-B---B-----?E---E--?o--BM-B---v
M-B?-?-Bo?-E-E--?B-?---M?-?-MM-?oEo?MM----M-?MBBo-oM-EBM??--B-B??B-E-oo---MEEMEM--Bo---M-o-?BM?B--BB?-Boo?M-EM--?E----?EB-B--oo---?BoMEo-B------BMo-BoMM-----?-ooo--oB--?---?o-?-B-?-M-BM-?o-?-M-M-B?-E-
Bo--oM-----MBB-MMoo--MM-M-MEM-E-M?M-o--?oB--E---BMo?MBE?-M-MB?---?-----?Mo-B-M-o---E---M?oB---?oE-EE--BBE???B------?---BoBE--?-B-?-B--?-E--M?B-----M-ME-o-o-B--oMMB-B-E--o-Moo??M?-EoBE--?BBB-o-oE?M-E?-
B-oB?-?-o-E--?-M?----B-B-o-MoM-o-BM--M?BEMoBM-----M-B-?-----?o-?B???-B-E-----E?o-EE---o??-oB-ooMM--Bo----?-B---B-----?-B--BM?o---BM--o---M-?M-Bo-oM--M--o??-M-MB-M?-oB--------?---MMoo-EB?-?-o--B-EBBMo-
-?-oEE---oM-o?-oMo-MM--E-??B-M-MB--o----M-M?-M?-o-----B-BB-Bo---E--?oE-Bo?EooMB?-B-EB--M?M-?-?-M--E---M-M-oB----MM--?o-----oo-ooEM?B----?o--?MM-?EMB-BBo-E--EMM-E---BE-BBBB-MM-MM---BE?BEM--?-----MB?oB-
-M------B--?-B---E--B--BEB-EB--o-B---Mo-Bo----E-B--EEMo?--?Mo-MEB-?-EM----M-o-M?oB-M-oT-?-?E?MM-EB?MB----MM--E-BMo-EM-BMo-BB?------oM-ME-o--B-?-M-B-?---o---?----o---?E?o?-?--?-?EB---EMM-M--BEBo---M-E-
--E-o?-E-BMo---?o--o-------?oM----EET?-?----BE?o--MM-EB---ET--T?E--M----oBM---M-TB?-o-|-----MB--?-M-o-o-TB--o-oMooo?T--Mo-BB-M?M-B-TT--M-?M?--BT?TB--o--Boo-ETBT?-ooB-?-----oMoM-B-EMM?---E--oMT-EB---B-
moB-ME-M--??-M?-?---M--M-B--EM--?-MM|MoMMooE?-?BMo-EE-Bo-oM|Mo|??oBMME--oB-o--B-|BE-?E|-EBB-BoE-B-EEMM??|-?-?M--E-EM|EMMB-E-?o?oEM-||EB-M-B-BE-|-|-Bo-o?-ooMM|-|-Mo?B-?-oEBoBB-o-?EMMM-oBEMBB-o|-?E-o???
XXXXXXXXXXXXXXXXXXXXXXXXXXXXXXXXXXXXXXXXXXXXXXXXXXXXXXXXXXXXXXXXXXXXXXXXXXXXXXXXXXXXXXXXXXXXXXXXXXXXXXXXXXXXXXXXXXXXXXXXXXXXXXXXXXXXXXXXXXXXXXXXXXXXXXXXXXXXXXXXXXXXXXXXXXXXXXXXXXXXXXXXXXXXXXXXXXXXXXXX
