-?--E?B--o---M--oBBBoB-M--?--?-ME-EEE--?-?--M----?BEB--EEM?-BBMEB--MEoM?-B?-o?-M?EBB?o--B----?-----o---ME-E-o??o-E--EB--oB-B-EBE--oB-Bo---M-M----MooBMEBM-oB-E--B--BM---?M----M---o--M--oB-oBEE-?-o---oo
--?B---M------B-?oM?o-B--M-o--M---M-?M--o-?-?MB----BE--MB---B-BM?--oB-?EE-B--Bo-BB--o-B--M-M---?---M--B-?BB?M-?--?o-MB--M----B?B?--oo-Eo?--B--MoMo-?-------?-B-B--oB??-----oBo---B---E--MB-?--M-?-oM--oo
---M?-M-MMB----o-ooM?--BBBM-B------oM-E-M-M-o--MM---ME--oBoo-o--ooo---MMB--Bo---o------?o----Bo-M-?Eo-MB?M--oMB-------M--B-B---B--o---B-B--B--oM-B--MoM-BM?B--?---M?-BB------M--M?M-B--o--B---?-Bo?-B-oo
-M--B?B?--B-o-?---?-B-----?-M-M-?-E--BB-o-M-----E?o-?M-EEM?-?-----M?--M--M---E--?--ME--?--MB-?ooB--M-M--MEo--B-?-B--E-MB--o-----oo----------M--ME-BEMB--E?oMM-?oB?o?MBBo---E?-----M----oBMoBM?BE--??--oo
-o-oM-B-?o--EM----oB--MoM?oM---B-MM-M-?-M?B-B---MBE--M----BE?o--o--?o--oB--M-B-Eoo--??EoB--B-E---oM--E-Bo--?---oM----M-B?Bo-o-MMB-----B-M-oMo-E?-EB?M---B-----?MMEBo?-BB---?-Eo--E---EM---BBBM-?Bo--B-oo
--?M-E?--?-?BM-o-oMoM-----M??-o-o-?-oM?BoE?-?-BoE-----M?B?B?-?oo?--oBo--B-oBoM-MMM?--o-B-?o?---o-o?-?BoMoE--?---?--B?MM-E---M-?-B-MM-------M--Bo--E--M--M-----???-MMo--M?o-MB-M---?--MB---M-Mo-MM-M-?-oo
--?Bo--BEo?---B--E?M?B?--o?--o---M---BM--Bo?o---MM-M-BB--EE?ooo-----ME--Bo-oBM--E--oBo-Eo?oM-?--oMM----?-?B-o-----M-BoB-?-B??-EE-o---MB??-B?oMBoE-BEoMMMB?oE--BEo?Mo-Mo--B?---B----Mo-?-MB-ooE--?BoM--oo
--M--o----M--o-?--M-MB-??-M-E-oB?M?-?----BEM---?-------?EB---M-B--BM-M-?-BBM-B-BM?-Bo-M??-oMB-ME--B-?EEEMBo-B----MM--o--M-MB--B-?o-Eo---BM-M--B--?------o-?M-?---?-?B-?-----?---?-?B------BooM-E--Boovoo
M---B?o?M--BM--M-M-E--?BB-?BM--?MB--MM---?M-Mo--??-o--o----E-oE-o-B---B------MBM---?MooM-B-E-------EoB?-oB-?----E-------?---M?E-B?-?--B--BoM-MoM-E-?-BM---ME-E?oE--?-B?---o-MBE-?o---M-Mo-E---oBM-o--foo
?oM-BBBo-M??B???-M-M?BB-----EooBM?E?MB---E--MMoM-MBB-B---Mo?-?Moo-o-B----M-----M-??--?o-EB--M------?-MB---E?oM?M--?Mo?--MM--BoMoM----o-?-B-E--MB?-?M--B?-E?----BM-o-o--Mo?-B-B--?--M-oM??-Mo---E--??Efoo
--oE-M-oE---?M--o?E---MM?-M--o?--o-Eo----Bo?M-M?---ooMM----E-?oME-----ME?-o-B-?-E?M--EBo-?-MB------o-E-o-?--M??BE----o-??E--M?M--??E-MM--M?---M--M-oM-EE-?-EM---M---?B?---oEM?M-M?B?E--MM-EBB--B-M-M?foo
o-?-B-?B-o-BMo---?M--MMMo-------oB-M?------M----?-?-o-?MoBB---BB?o-o---BM-o-B-E---M--M-o--oBMo--M--B-B-oB-o-?M-B--B-?E-?M-o?E-B?-B---?M??M---oB--oo-MMBB?o---B??MB-o?-MB-o?----M----?oE--MME----?oo-ofoo
EE--??--?MM--?-??-o-oMB-Bo-MT---BBMo?--B?----MMEM-?--o--?B-?BoEMB-MM---?---B--B--?oM--M-ME-?--o??MB-B?----M-BMM------?--B?Eo-oBM--oM-?--o-B-ToEBoB-oM-----M--o-T-MoME-Mo-?o?-o-o-o----M-TBM?oM-?--EE-foo
B---E--E-MBMM----?Bo-MBME--?|M-----TT??--o-EE-TMo-?T?o--o-M-?E---BB-o??-To-TM--o--oTM-oM-?T----oM?TBT-EEB--Mo-B-TBTM-M----B-E-E-Eo?-----T---|?MM-o--T-M-T-o--?M|-oo?M-T--EM-M--M-T----B-|?EMT-o-EB-M-foo
m-E----M-BoBBBMM-EBEMMBE?BEo|-MBo--||-E-MBo??E|B---|?-EEMoo-E?E--EE-M--o|o-|-----BM|BBEM-M|-B-B-EB|-|MMM-o-M-oEo|B|--B?---M--oB??MM-EE-o|MB-|o--M-?-|?-E|-oEBBE|-?-??M|MM-?BB??-M|-oM-?E|B?-|E-M---?-foo
XXXXXXXXXXXXXXXXXXXXXXXXXXXXXXXXXXXXXXXXXXXXXXXXXXXXXXXXXXXXXXXXXXXXXXXXXXXXXXXXXXXXXXXXXXXXXXXXXXXXXXXXXXXXXXXXXXXXXXXXXXXXXXXXXXXXXXXXXXXXXXXXXXXXXXXXXXXXXXXXXXXXXXXXXXXXXXXXXXXXXXXXXXXXXXXXXXXXXfXX
