M-??---------?----B------o-??----?o--BB--MMM?-o---B--oE-o?MooB--?-o--Mo----Eo-?oE--oE--E----o---o-EB-E-o--E--o-?MBMME-Mo---B???o-----MM--o--E-?--?----M---oMMEBMB--o--------E---o--oMMoE-?M----B-M--B-oo
-o-EBoM?---o-B--M?--BB--oM-----B---Boo?MoMooM---B--oo-M------o--?E-E?-E-?E-BB-o-?-?-MB-B?-o--M??-E?BM-EM?--M-----oBM--BM-B-?o-oo-MM?-?--oBB?BE-B----B---B?--BM-EMB--B-oMB?-M------o-M-o----BE----oB-E-oo
?-?-Mo-E-Eo----o-?E--------?-E---M-M--B?----BM----?-o-o--?M--M-o---B--Bo--o---M-M-B-?MB-B-??--Mo-ME-M---MM-EM-EM--oo-oB----o-?Eo---M--o---?MM--o-BEE?B?M?--M---M?B-oMEM?E--??-----M------?-BMMo----M--oo
o--B?o-MoBo--MM-E---?-oo-B--M-B?----MEMM?EB-BB-oEMBM?o-oM--o-B??----o-----BBM?--MM-M-BM?o-MB-M-MEBBM?--?oB-?---oE-oBBoB---B-o-M-E---B-oB--o----M-EM?o-B?-?E------?-B-BM-Bo-E---o---M-o?---B--MBo-MBM--oo
B----??M--BB--EM--EB--M-M--B--?M---M-----BMM--oBM---M------?---?--oB--BBE---?M?B??-ooB-M-----?-B-Mo--o-o-B--Mo-??---B--BB---Mo-----B--?--?-----M-?-M--E--o-E?EoEB-B--oo-oB?-----?--B-o-E-o-BoBE?Bo-oM-oo
-oM--oo-Mo-?---M--?-B---M-----o-----?B-M-BE-M--EM--M?E--Bo-EBB--MoM-M-EoB-o-E-?-oE-?E---BMM-oM--MBo?--B---?E-B--E-B--B-BBBM?-?ME-?o--BM?M-M--MM--MoE----?B??E-MM--MB----------B--Mooo-E-o?-M-BB?------oo
oBBE-E-?EMo--B-?Eo?MM--oME?M-----MB-M----o---B-B?---??---?M-o---E--E--MMM-Eo?MMM----??-------?-B-M--o-----EM---M?----?-oBE-?---BM-MoM--o-?--?EoE--MM?o?E-B-M?M-----E-?B---?o?EM-MB-BB-M-o?----??--B---oo
-BB?-B--M-?--o-B?-E-??-B?B-?BMo?oM------?---o---ooMMM-oB?B--?--M---BEo--E??--?---??oM---oo-B-?BB?-B-E---o-M------M--M--B-MB-BE---E----M--o----E-M-oE-M-B-----?E---oM?o-M?-MMoMB-E-oBM-E-?o?--E-Eo---ovoo
E--BBMME---M-B?-----o------??BoB---EE-M--?--o------?-?-M?--M-ooB-o-E??-B-B--o-B----Bo--B?----------B---EBBo-B-?---B?M--M--M-B-E---o-?MBM---B--B--Bo??oM--oB?-E?oo----M?MoM-B-o-MB--o---o--o-BB-?M--o-foo
B---M-B--B---?-EE---MB?---oB--MEo?B---oo?E---B----o--?--BE---o--MEM-o--?B-B--------o-?B----?--E-----MM---o-M--?MBB-?---B-B-?-----o--oM?-----EB--BMBB---oM--?--EBME-M?M----MEME--?--?--oo?M-?-Bo-E--?-foo
----oMMM----MB-M--Mo-M?-B?MB-oB?--??oE--oME---------oM-M-----?-?--Mo-E----oMB?-B-?-MB-M-E-B-M----M-?---B?oME-MB-----?E-?--MM---o-Mo?-o----?o---M-B?---BB-?o-o-M---MB--?-M?o-MMB---MB-EBM-?M-o-----MB-foo
-?---BM--B?-----?-??BM---oBM----oEM-E-MoM--M-MoBM--o--EM---M---o---EM?E----B?oB---oo---o--?oM----BB-?BMoM-E?B?-?B?E??M-o?--oB??o---o-M-BoB--E--oo--o----M--?--BE-BMoM--o-M?o-?M---M----?-B--?M?-??---foo
---o-----MBBoB-o----?o??M-B-o--?----B-oB-E?MB--B?-oB-oM-BB-o--?B--EM-?B-?-BE?--oEBEM-o-B--?-B------B-oB?o---M----o-o-?-MBo-B--oBB--?--?-o-B-BT--M--?E?-o?-------?B-?---Eo--ME?E--?T-ME-M?BM-BMMBo----foo
o--BoTB----TET?-BET----B--o?---BBTMEE--?oBB--B-o-o-oB--?B---BoB??MB-??-M--T?--BT?B?oMo---oM?-?--ETE???o----EMT-T--MTE---T-?B----?oE?-E-M-T---|BoBBo-MM-------B-BTM---?BBMT?-T---?-|-oM?-oT-T-oMB-TET-foo
m--M-|B-oo-|-|B--?|?-?-M--o-EMM--|-?BB-oB?BBo?EE?M-?EEMMEoBMEM?B-MM?M?E?-?|-EEo|-oo?Bo?EM--EB--BB|-oM---B-B-B|o|-B-|--o-|EBMEo--M---o-EM?|--o|M-E-MM-MEoBBo-?M?-|E?-EEoMo|-o|--Eo-|EMoEo-|-|?BE-o|M|Bfoo
XXXXXXXXXXXXXXXXXXXXXXXXXXXXXXXXXXXXXXXXXXXXXXXXXXXXXXXXXXXXXXXXXXXXXXXXXXXXXXXXXXXXXXXXXXXXXXXXXXXXXXXXXXXXXXXXXXXXXXXXXXXXXXXXXXXXXXXXXXXXXXXXXXXXXXXXXXXXXXXXXXXXXXXXXXXXXXXXXXXXXXXXXXXXXXXXXXXXXfXX
