-ME--M-Eo??-E---B?B--o-B-----MoM--o----o?-?----M-o?--o-B-oBB---EB-MMo-?-oooB-oM---o?M-o-?-?o---B?E--B-B---?--BMM-Bo-M-----MM--B?-o-MB----oBMo--BBo--?--MM--M---?-?-?-M?B----B-oMBMEBo----MBBo?-MME-?M-oo
--B--o?M--o-B-oB--BB?-?---oBoBBE--?M-B?-EM---?--?-?BEoo-----o-BMo-?------M-oM?--o?--MEB??---E-?--?-B----B?M?-M---MMM-oM-BMBo-???--MB--oo---B-E-oB?-E-ME?BBoo-?--??BEEBB-?-Bo-o-E-------EM-Bo-o----oEo-oo
?MBoB?M--BoM-----o-M?o?---E-E-o--o-EBB-?-oMoM?--B---?-oo---oo---B?-o-EB-o?--?-E--oE-M---?B-oBoM----o-----?-oM-B--BM-?o-----MBE--Eo---B-E-E--M-o--B--M--EMMB--E-M?Bo?B-?-B-oooB-M-M-?--oMB-o?--o?BBoBo-oo
B--?-o-?o--o?--M-B------oMM-Mo?MB--?o-----?ME?MM?-----M--E-?----B?-EoM--B--MBMMo--B-M--BM---o-BMoo-?-MB-EM-?-E--?o?-BM---o-oMBBoM--B-?E???--?BMB--o?-E?-?B-?-?B-??-o?---?----??M-MMMBoM--oM-o----o?---oo
EMMo--------Booo?BBoB-------o---?-o-o---E-?MB?B--?-M?-B-oM-ME-o?B-??E---MBB----o?M-B?--?o???-?B?M-oBEEB?---M-B------?-ooM-EBo-E-E--MBM---B-o?M-?BBBo----M?M---B---M---?ooMEo-----M?--o------?--M---EE-oo
-o--Mo-B-ME-o----Bo?o??-MB-E?-ooMM?M-MM-M-B?---MMB--MBEM-?--MoMMo-?M---E--?B?ooo---oo-?o--EEM--B-o??----oo--E?M-o-M?B-----MB-MMM-EM---B--?M?M?---M-M??--BB--M?B-o--B-M-M-o-B-?B-M-?----BEEB?----?B--M-oo
-?B--MMBB--oM----o---EB-o---o-o--?---BM---?B---o-MBo-MMo--EE?M?--M?BB-E---?o?B?BM--o-MBM-oB-B--?----BB--BB-BooEE?o---M-?--EMo--?-MBEo--ooMMMM-MM-BoEo---?-E-E-o--?B-?-oMoB?EoM---E--Bo?-?B-MoM-?-BEEo-oo
??--B--?---?-o-?-oM?B?-Bo--M-EB-----B??M---o?-EEoo-M-EM----Bo?oo-B--?-Bo--M-o-BBoB-oMB?-MB--??oBoME?ME--B--oMoB--M-M------M-o-EBM-BM---M-?--o-MBoBM----?--M--?M-MB?ooo--B--?--Bo-Bo--?oMBME----E----Evoo
MMo-B-B-o-E--?M-BoBooo?o---oBB--M-?---BB-BMMo--Mo--MBM-B-M-o---ME?-o--B--oME-M?----?-o-o?-M--EEo-B------M--EooMMME-E---B-B?o-M--Bo-M?---Mo?--oM--B?M--E-E-?---o--o?oME----MM--o-----M-?oM--B---M-B?--foo
BM--?--Bo-M-?BEB---MBB-----?-M---ooo?o--?o-oM--M-Bo-----BMEMo-M-M-M??------MBo-B---EM-B?-o-M--?Bo-B-o-??-B-B-B---B-?---M???M---BEo--BM----M-M??-??o-Eo-oMo-o-B---?---B?M-E--o-o?o-E---o-?--?MoB-EE---foo
-M-----?-o--B-B?oo-----oBo-B-E-o---?--------BB-?-B?Bo-MB---M-E---?E?-?--o?o--o--E-----o??o----BM-oMBMM------?----B----??B?E-BM--B---?-M-----M-?-oB--B?--oBo---B-M-o-EME--M---BE--?--oo-E-BMBB?MBBB---foo
-BMMo-M--BM-----?-E----?M-oo-M-B-M-M?o-M----?o------o------BEME?--M--o-M-B---BE--B-M?---o----o?---B--oo-EMM----?-EMMBE---???----M--o-o??-o-MoB?Mo?--oEE?--EM-E----BoBMME-o-E-E-oE-oM--o?-o---M-MM---ofoo
--?-M---B?B-oo-EE-M-o----B?-?oEB?B--?-E-o-Mo--?---?-B--B-MM-BM---E?o-B-o?MoE-B?---MM?MB-?-BoM-T-o-BM???--M?-o-oE--?Bo?---E-o-?E---M?---?EM?EBTM--BM-E-?-?----MB-EBo-B?TBM--?--M?B?--oo-?EMB-o-o---o-Bfoo
--Bo?T--TMMTo-----?E?-B?-oTBTBTMMMo-BM--oBo---?-B--MMMT-Mo---o--oBo-?--o?oo-----?--B-To-o?ME-o|--MEo?o---EB-M-TM-?EBMT---??-T-TB?ETM---TBBBT?|T----B--oM-M-MMT-?M?-M--|BT-Eo?B--EM--E-T----B--TBM-M-ofoo
mEo-E|?M|--|B--oBE-?-MM-E-|-|B|E?--E--EoE-E?oMB---oM--|?-oEEM?-M---oo-MM-B-oB?BM-?-E?|-BE?oMM-|?-E-???-ME-oEE-|?o?M??|??M--o|E|M?-|-BoB|o?o|-||--M---ooMM?BEM|o-?--B-M|-|-B-BE----?M--|E--o?-?|-oo-M-foo
X----------------------------------------------------------------------------------------------------------------------------------------------------------------------------------------------------fXX
