ooM?-BE?-M--B--?oo--?BM---BB---Eo---M?---?M?-----M?E?--o-MB-EM--B----Mo--MM?-oB-BM-B---o-MB-M---o-B-M--?EB?EM-o---oM-o-----?EM-?MMM----Bo-E-M--EMM?--MM---B-o---M------BMoo?B-EEMo?---?-B-?-E------B?-oo
oE-o?-MB-BMMo--M-M-EBBEB------o-ooo-o--E-?B-E-MEBBM?--?oE--B?--MBE?B?-------?o-B--?oM-----M-o-o-E----MM?M--M-E---M----o-M-?-?-MMM-BE--E--M---M?-?---M-E---M-oB-Booo?-----?---M?--ME?-MoE-MB-----oE-o--oo
---M--M-oB?--EM--oB-M-?---?-M--EMBB-M-----M-B-EM-B----MM-----?B-B?-oEo-o---BB-o?-Mo?oBBB---BB-oo?----------o-BMo-E-----E----o----BB?E-Mo-M--oEEB---MMo-E-?Mo?-oMB--EMo-M-MB---o---?EE-??oMo-M---B?B-o-oo
-----?Bo--o?oBE?B-B-E----MBM--o-B-oEoMM--?-?-BM-E-?EE-B-MB----oE-E-M--B?--o-o-?----?-BB-M?oM------BBMo-EM--MB--E---o--??MM---?-o----?--o---?---M-?E-?o?--EE-MB-EM-?M-?B--B-B-?MM-----Mo-BEB-BB---?oo--oo
---oo-o-o-BB----o-EM-B?---M-B-?-oBMM---BE?---?-B-oM?B---MME-MoEB----?oB--BEB?--oB?ooMBM?B-B-o--oM-oo-o-ME-Eo----oE---MME-?ME--o--??----?MM---EM?-B--M--M-MBB--o-B?M?-MBoEBM-o---M---Bo-?-B--oMo-oMB---oo
o--?---M?oEo-------oB?-?-BB-E-M--o----B-M--?----M-MoM---M-MM--B?--??--oMoo-oEM----??o?-M?oMo?----MB?-------o-EEBB-MBo--?-MBMo?-E--?B----MMoM-?--Boo---oo----B----?-?-M-??-?oMM?o-?o--??o----M--BM---M-oo
-?BEE-Mo-MM---oB-?o---?B?M-B?-o-MB-BB-oo-Mo?o-------o---BBE--ooM-o--o----?---?---B?B-ooM---oB-?-oo?---MMo-E---B-M-?--o----B-BoE?-M--?--------?--??-?MB-?oM-Bo-Bo?B---oBB---M-?M-o??-Eo--EB--?o---M?E--oo
-MM---oB?o-B-E?MB-oBoM?---M?oE-BM-?--BM--M?B?-Boo-o??-?Bo----?--EM-------M--Booo--o---?B-?MMoM---??-o?o--BM-B---M-oM-o-MMoo--B-M-M--?-EB?ME-B---?-o-ME-M--o-?----Bo-M-o-?o-o--Boo--B?-???o---o?-?-E-Mvoo
-o----?EM--BE----?EE--?---o?MM-E---ooM?Bo??-------BM-MMoo-EBM--o--oo-oBoEMBE?--o-M-EBoB--oEM-------o-???-Eo----?ME??oMEE-M----Bo-o-E--B--oB-B----M-------M--oo?---B-M-E--EoooB-?-----o--B?B-B--o--?-?foo
--?o----??--?-o-M-??---o-?-E--oBB------BE-B---BEoo-M----BB-M-o-E--MBM---?---?---M-MM----o?BBB?B-EB-BE-M-M-B-E--MM--M?-----B-M?E----B---ME---?o--?o-----?-?B--MoB----Bo------E??-EoMBBB----E---o--MMMMfoo
-E-E-?B-MM--M---M-M--E?-oMB--ME-E---??o----??-E-oMM-?-o?-EM-EoM---oM-B--M-?-MEBo?-?-EM-Eo------M---BM??---oB?EEo-B-?MB--o--BBo?------EM-B-M---o---B-o-B-BoE-M?B---?--M-BBE--Mo--BB----ME?oMBE--------foo
BB-MMBB---MEM?o?MEM-?MEo--M--M--M-B-?o---BMoBE--B-MB--M--?---o---oB-???E-M-?-B?EMo--BoM-?B-o-M-----oo--B-M?---?--MB---E-E--oEE-o---E-?--MoB---o---?-Eo?-o-Bo-------M-----?B?---o?------M----B-o---B--foo
-M--oo-B--?Bo-B---M?---?---Boo???BE----T--o-M-MBooB--oB-B-E-oB--M----E-B---B-M-B?--BToB---M-E---EME--M---oB--o-BMM-??E???--B?--oBo?--?Mo-o-o?MM?-?-E-MoBM-BBoEE-----BooT-?Mo?---EBo---BM?-BM-BB-oEEE?foo
--BoMMET??--TB?TTMM--?M--MoBM-----MMT--|?--o--?-o-o?Bo-MT?-E-B?--E-BMT--o-B-M-B--o--|-o-ooTM?--E?-?B--o-oBMB-E-EMooo-B---E?-T--TT----TTEBE-T--E-EMB?E-T-E--T-M-M--Boo?T|---B--M-MT-T?M?--?---o?oo?-?ofoo
m-----B|?EE-|M-||oBEBB-?-?-M--EM-EE-|M-|BM-ooB?MoM-oM???|EoBE-B?-BEM-|?-M?--?o-M?BEo|---MM|Bo-o-BMoBB-B-E?M-E-E----B-EEE--E-|oM||MoMM||--?-|E-?B-B----|BMoo|?M----EoE-||B--Eo?M?-|-|-ME-o-?-oB?--o-?Efoo
XXXXXXXXXXXXXXXXXXXXXXXXXXXXXXXXXXXXXXXXXXXXXXXXXXXXXXXXXXXXXXXXXXXXXXXXXXXXXXXXXXXXXXXXXXXXXXXXXXXXXXXXXXXXXXXXXXXXXXXXXXXXXXXXXXXXXXXXXXXXXXXXXXXXXXXXXXXXXXXXXXXXXXXXXXXXXXXXXXXXXXXXXXXXXXXXXXXXXfXX
