-oBM-Booo---EMoEooM-M--o--MMo-M--o-MB-B---o-o-o?--E-M-M-B---oB--EM?-BM?-----B-oM-?-?MoM---oM?-Bo--B-M?MBM?oB-?-MEMBM-M----?-Mo--EM-E----BMo-----E?-?M-?Eo-M---B--o-o-B--oM---?E-B----M-M-Bo---M-MB--o-oo
---M---MMM-BMMo--M----?-BMM-BMMEM?oB-M---o?------BMB?-?Mo--o--MB?M-?-oBB-E--B--B-----B-?-o??-MM?-M-o--BE-Mo-o---M-?--?Mo--M-BME--B---EB--E----EMB--B?B-----Eo---EB--o--BE?--Eo---?-?o--E--o-o-Eo--?B--oo
E-?BEBM-o---?---EMo-E---?-BEM---?--ME--oB-BE--BEM?M-BB----M-M--BBB---o--BM--------E--o-?M-----B?o?------M-Bo-E--B--oM-o-M-E--oMMMooMo?--E-Eo-B?--E--o-??----MMo-B--BM-o---oB---Mo--B---BE-B??E?E-ME-B-oo
BB??M-M-B-----M-BB-M--?-?BoM--M-----?B-E-BoMoo--B?Bo--B---M---oB-B-o-?MBE--B-BMo--?-E--oo-----?-E--E--Eo-MM--B?--Eo-ME-o-oB-M--B-BM------?B---M--M?-o?B-B--oM-??-MM?-M?o-B----E?-M-E-----o--B-BB?-?Bo-oo
oB-MM-o-Mo----?-o--oM-?o--MB---?--E-o---o-Boo-oB-?B--BoB--M-M-?------E--Bo?---?M-----?-E?-o---B?BBM-----?BB-Eo---BM-B------o--MM-?B---ooEo-Mo---oME--?E?o--?--BB---M---B-?BM-o?M---?--oB?-o-oBM-?E--?-oo
--Mo--BoBB----M-?---E--o---oB-?---B-oE?-----MBB--oM-----oBE--Mo-o?E--M-?Boo?ooE-MMoBo-o------?M?--o--MB--o?-M-o-MBB-?--Bo--EBo-M?-?-B----o----o-BB--MBMMoBo--M--M-?M-B--B--o-?----MB?-B-M---B-M-M--Bo-oo
-BM-EM--M??-EMoE---?B--??Eo--MMBE-E-----E?---o----o-?-??B?----Bo-M---MoE-EMoM?M--M--B-??-oB----Eo--MEB--?BEE---?-oMMMM--oB--E-Eo-ME-MM-oB?BB-E-??E-?-o--MM--B----M---?-oB---B-?E--MM--MoMo-o-MB-M-??--oo
-o-EB--??---?-------EM------------B---oM--M--??M-B-E-----B--BoM?--B---?-oBB?M?-B-?oBEMEM-M-o-?E-o---MM---MBMo-B---o?--E---o-??Mo-M-----o-M-MEB---???M-??M-o-?--o----M?M-oM-M---BoM?--B-E?ME-o--B--?-ovoo
-?-?B--Mo----o-B?MB?B---E--B--Bo-M?M?-o----???B-MB-M-?-?o---Bo-B?-M-o-E?E?-?---?----B-?-E-MBM-M-M??-B-???-oo---B--oBB-?-MB----oM---?M?-Mo?-o--B-?--?--B-?o--?-BM-M----MME---BM?M-E--o-o--?MoME-ooE---foo
?---BBMMMEB--B---M---B-BB?----oo--Eo--Eo?--MM---oM----------oB-E-B?B-oM-M?-E--o--EE?-oBE-EM?--BE-E?ME-----o-----MEEEB-M--M------o-?o-??-BBo-MMMM?---B-B--Eo---o--oM??M---B-E-o-----M---M-M-Eo??-?BE-ofoo
BE--?-?B?BME------Bo-E-----B-BM-MB--EB--?-?---?--?E-E-B----B??EM-B--o-?oEM-?M---oM-B--MB---?-E--E--??E-BM-?o-E---??M?B--BB?--oBBE--M---M--B----M---o-oE-MM-B-BB-EBo--B-oo----MBo?EMM-?BM-BoB-o---MB-Efoo
--o?----M-------o------o--M-?oo-?o----ooBMBEooo-o??BMo-M-?B-M-?-B-B-B?-----M-ME-EM--o-o---oBBB-oM-ME-M-BoMo--M--B-BBB?oM--oMoEM?----MMMooB-Eo-B-EM-Bo-----MM--?oM?oo---B-MM-BMMMB-?--B--?--M?BEBo-?-Bfoo
M-B--BB---EB?-?-M?--ooM-?E---?------oooEEMo?E?--M--EoM-M------M-?o-?------?----B-----?-?-E?-?B-ME----M?EBTE?-M-B-oB--M-B-oEMoB--M--Bo-M?o?-?o-M-MM--M-?B--?E?-o-?M----o-M?BoB-o?-o-B---MB---o-------Mfoo
--E-?--MMTMM-o-?oBEo-EE-E?--T??-T-TE-T-T?---TB-EoBBTTTE-o--E--B-oBoM-MB--TB-MMM----o--??-?---?MT--oM--M-?|-oEM-?o?B-oET-?B-M-----B--?E---?-ToMoBooB-oE-?oE--Moo--TTB--oT-B-oT--T-o--E--oE----BE--o---foo
mEB?o-?oE|?o?----o-M-MB??o??|EoM|E|BE|-|-o-E|o?BE-B|||MB-oB??-o?E?Mo-oB--|?E-?-E-E?oB-M??o-B-o-|-MEoE---?|EEB--?Mo-E-B|--o-----E--EEoB--o-E|B-?EoMEB-MBMM--BE--?B||-E--|-B--|-M|--o-M-Eo-?E?Mo??-?--Efoo
XXXXXXXXXXXXXXXXXXXXXXXXXXXXXXXXXXXXXXXXXXXXXXXXXXXXXXXXXXXXXXXXXXXXXXXXXXXXXXXXXXXXXXXXXXXXXXXXXXXXXXXXXXXXXXXXXXXXXXXXXXXXXXXXXXXXXXXXXXXXXXXXXXXXXXXXXXXXXXXXXXXXXXXXXXXXXXXXXXXXXXXXXXXXXXXXXXXXXfXX
