---oM?o-?MB--BE---EMoo-M?o-oBBo-oE---B-M--?-o---o-M----MM-?M--o-oBM-Bo-ME-oMMMB?---M-M?--oo-oo-MMoM-ME---o??oBMBoo-EBM--o--E-?o--o-B-oE-MM-----?-E?-o---oo--??-B-o-oM-MB----B--BEo----o-Eoo?B-o--M----oo
BM?M-?--------MoBo-Mo-???--o?B?B----BM------oEo--B-o-E----M---M--B--B-M---M-oE-B----o?--?B----?-E-MM-M-----o-M-B----M-BM-o--BB?-?M-----oo?BBMMBo---o?-M--------B---E-oo------o-o?--M?-EEBo---BM--M-ME-oo
-M-----B-B--?oM-M--MM-----Eo--B?---?---oMMo--Bo-oE?EMM--o--?-oBM-M--E-o--E--BBE--o-o-B---MEEBoM-B---??Mo-?ME-B--oBM-?--M-?-----Bo---o-E-M--E-B--o---E-o---oo-?--E-oM------EM-EB---oM-B--MM?o?---M---?-oo
--B?Bo----ME-Boo-E?E-o---oMB-?B-Eo----B-E-EE----???MooM--B-EoE----M-?--EEB-o-E?-B-o-oo?o-M-BEo-?-E--M-----EMo---oM--B--B-M-?E-B----?-o-o-E--oM?MB-o??-----?---oB?---E----o-BoB---BE------o--Mo-----?--oo
---oM-E-EE----o---BBB?BB-----?--BB--M-oo?--MB-BB---B-o?oE-E?-B?-M-BEMM-B-o--?B------?o--o-?E?o--o----?-M-o-Bo----BME-Bo--BEB-----EE----M-B----M------o--?----B--oBo-?--oEM-M-?-?-B--EBMB--Mo--o----MM-oo
-Bo--o?M?B-----MB??--MM-oo-E--o-E-o-?-?--B-BB--M-M-B?BEM-E---M--?-B?-?--E--o---o-?-B?--B-------MB-M-M---?-----?-?o?-EME-o-?o-E-B?B--E-M?-oo--o-???o--B-M--Mo-E--oBo-?M--M------B-?E----M---B--o?--?-E-oo
--E--M?o-?-M-----oB?--B---EB--oo-M-oBMo--M---?Mo?MoB-oBE-B-M--M--?B?o---?-o-?M----o-Mo-oM?----o--o-E-?M-oo-BMo------?oB--oM-BB-BM-M-M---MoMB-?---o--ME-o---?BB-MB-E-B--o-o?o-M-o?oM-------M?B-?--E-B--oo
oEMM---M-Mo?--E---BM---o-o-o-EME-------E--??-o--M?----M?E--o-?oB-------M-o----?B?o---o-o-EB------??-M-E---?---EBMM-o?o----BME-BB-B-??E----MEM-E-o?---Mo-?--?-E----B?-?-B?------B------oEE-MoB-B---B-?voo
o-BB-o--M-EB-E-Bo--?-o--E--o-B-MM-Bo------B----------E-BMM-MoME?E-MoBo--B--BEBEM--BME--MMMM-MoM-MB--B---------B---o?-B-B-BBoB---B-----?M---M?-?MB-B-----BB-oM--o----B-------E-?-M?--B-??BBo---Booo---foo
M--ME-?-?-?M-------M-B--MB--oE--?-o---oo-?B--EB-o--??BE-----?BBM-BB-B?--EoEE?B-----?M-MBEM?---BBBE-ME---B--o--M--EB---?--ME-o--?BME-M-E?BMEMB--M-B---E-oB-----M-M-?B?-MEo--M-MoE-?o-E-MoM?---BBo---E-foo
---M?-E---B-M-oBE--?Bo?-E-E--??o------oB-----?Mooo-EM-----oM-M--M--B-?-EBB??-o---oE-o-?M?--B-?BEMM-?-B--?-?-M------B-B-B-?BM?-M-ooBMBo-o--M-EoMM-?EBo?EooM-??M----BMM-o-B??-M--?-oo-M-MM-M-o--M---oM-foo
------Boo---o-?-M---o-E??-MBooMB?M-----B?M?-?M-B-----oM?-B-?-?-M--?T-B--?--B--o-?EM-BB--E--------?--MoE-?--?-o-M?--?MB-MBM-EM--M--M--E-EMo--?BBEME-?B?-E-?oB-MoB--o--M--MooE-----M---o?MBB-Mo?-M?M-M-foo
---BMMB-MM-o--B--E?oBE-----T-BE-?---o--M-M--?MoE?-oEo?o-?o--M----o-|M----?-E--oB----?-M-M-M---M--o?o--M--M?Bo---B-M-EME--BBT?E--?BE-BMB?-oo-B-B?M-B-Mo-M-?--?M-??M-MooBoB-M?-?-?----B-T?B--MMB-?oB-?-foo
oMoBBBoM----oooo-?---M-B---|-?-EMoB?M?-oE--o-o--o-EM-oEE?-o-T?E-o-M|-oM--BET?o-Eo-o-M?Moo-T?---E-M--o-TEo-TME??--MM-?--EoMT|?-ET-BM--??o---?T---?E-ooBT--ME-BoE----T--oTET-?MMT-o-B--M|T-T-BEo-oo-?--foo
moBEE-M--oo-o??Mo-BEBM--M-M|o-o-BEMM-M-B?B?MoM-?oM-MBB-?-MEo|-?o-E-|--EE?-B|oo-?--B-MBoMEE|-Mo?MB--?--|---|-MBoEEBM----Boo||-E?|E-E---oBE?Eo|-E-BME-oo|-?-M-BMM?M?o|oME|?|-E--|EEEE---||-|?M-?B-?o--ofoo
XXXXXXXXXXXXXXXXXXXXXXXXXXXXXXXXXXXXXXXXXXXXXXXXXXXXXXXXXXXXXXXXXXXXXXXXXXXXXXXXXXXXXXXXXXXXXXXXXXXXXXXXXXXXXXXXXXXXXXXXXXXXXXXXXXXXXXXXXXXXXXXXXXXXXXXXXXXXXXXXXXXXXXXXXXXXXXXXXXXXXXXXXXXXXXXXXXXXXfXX
