---------------B---------------------------------------B-----????---o--o-------BBBB????---------------------------------------------------------BB------------?-----------------------------------------
-----------------------------------------BBBB-------------------------------------------------------------------------------------------------------------------------------?------------------------XM-
----------------------------------------o----------------MoB--------X----------------------------------------------------o------------------------------------------------------------------------------
-------T-----------------------------------T------------------------T---------??????-T-------------------------------o-----B----------------------------------------------------------------------------
-------|---------------BB---------B------?-|-----------------------B|BoBBB----X------|--------------XXXXXXX--------B---------------------T--------------------------------------------------------------
-------|-----------------o---------------X-|------------------------|----------------|--------------------------------------------------M|--------------------------------------------------------------
-------|----------------------X----------XX|--------X----------X----|----------------|---------------------------------------------------|------------------------XXXXX---------------------------------
-------|----------------------XX-------T-XX|o---????----------XX----|----------------|--------------------------------------o------------|-----------------------BBB-----------------------------------v
-------|--------------------o-XXXX-----|-XX|X-----????????---XXX----|T-?-------------|--------------------------o------------T-----------|----o---------------------------X---X--------------------X---f
-------|--------------o-T----oXXXX-----|-XT|XX-----XXXX--o--XXXX----||--------???????|----------------BBBBBBBB---------------|X----------|--------------------------------XX--XX-------------------XX--f
-------|B-------------XX|TXoXXXXXXX---X|oX||XXX------------XXXXXB-B-||o------T-------|-------------------------T---------BBBT|XX--X--?---|---------------------------o----XXX-XXX------------------XTX-f
-------|----------------||T-T-XXXXXX--X|BX||XXXX------X---XXXXXX----||-M-----|-------|-------------------------|------------||XXX-----o--|------------------------------T-XXXXXXXX--------o--------X|XXf
-------|----------------|||-|BXXXXXXX-X|XX||XXXXX--------XXXXXXX----||-------|-------|-------------------------|-XX---------||XXXX-------|------------------------X----?|-XXXXXXXXX----------------X|XTf
-------|XX--------------|||-|-XXXXXXXTX|XX||XXXXXX------XXTXXXXX----||----T--|---T---|-------------------------|XXXX--------||XXXXX------|---------------T----M---XX----|-XXXXXXXXXX---------------X|X|f
m------|----------------|||E|EXXXXXXX|X|XX||XXXXXXX-EMEXXX|XXXXX--E-||----|-E|---|---|-------------------------|XXXXX-Eo--E-||XXXXXX-----|-----------E---|--------XXX---|-XXXXXXXXXXX----X---------X|X|X
XXXXXXX|oXXXX----XXXXXX-|||o|-XXXXXXX|X|XX||XXXXXXXXXXXXXX|XXXXXXXXX||-???|M-|XX?|???|??XXXXXXXXXXXXXXXXXXX--XX|XXXXXX-M----||XXXXXXX----|XXXXXXXXXXXXXXX|----XX?XXXXXXX|XXXXXXXXXXXXXXXXXXXXXXXXXXX|X|X
