-o-BB--o---o----o-E-o------M---?oM--o--B-ME-E-----M---M--BM---BMME??--M-oM-oE--?E----?BMo--M-B-E-M--BBo--o-?---??o-E--B-?-M--E--?-?-------?-?-?B-?-B?MM--M-B-?EM-MMB?o---M--?M--------?BBB-BBBooE-?oo---
B-?B-?-Mo-E----?MBBMM--o----BM-----?---B-?B-M-Bo--MB-B-B-BB--oM-oMBM---B?-B?M--?M--B--?---o-o-o--?-oMo--Bo-MoE--MMB?---BM---?-oo?---MMMBo----o----??-BBooM--E?BMB-B-E--B?o--E--BBB---ooMo-?-----B-?E----
-Bo?oM?--B?BM?---oB----Bo-----?-?M-B-Eo-M---oE--BB-Bo?o-o--o-?MMoMMM----E-M---MB---?-o--ME-o?--?M--ME--Mo?----oMB?o-E-?M---oM--M?--?M--B---B-B--EoMM-Bo-----BE---------?o-B-B-Boo--?oB-EB--E-o---?o-----
---B-B--BoEo?--M-?oo-o-M?-o--o-o-B---MBE--?-BMB-----E?--o--MM-B-M-Mo-??---o-?EE-EBEo--E--Mo--M---EM??o-o-??B-M-?o---M?-----?B?--E-E--?Bo-oE??---??-?oo-BM--EBB?----MMEoM--?M---M-oooBBoBB?M----M---E----
E--?oB---M-o---o-?MB-M-oEE--MoM-----o?-?o-?-M-EMo-B?M--oM---M-ooB-E---MoMM-?--BoBoB--oBo----o?-E?B-M----?E-?---MB-E--ME--EM-o-??B-MB-?------o?-B-B?E--Bo--?-o?-B-??B--o-??--M?--o--o-o-----E---o-B-?----
?oo?---?M-BE-oo?-?-o--???o-MM-M------?BEo-B---------?-----o-B--oo--EMB-EoBM-o-o-?-Mo--?o---M-MoB???M?-MoE-M-EE-o----oB-???-?-B?-BEoM-----?-?-?B-o?-M?MM?EM---?----?-EM--BEME-o-B-----o-----?MEoo--------
-?-Moo--B---oBE?-M-MoE-?-BE-o-o-o?-oo--M--ME--o---E?---oB--B-BB----?-?-?---?BM--MEo?-B-o??---MEM-o--M-M---?oM???EEB???-EB--o--B--B?-?-E-B--EM-??-EMBBMo-BB--o?-oB-?-MBo--M?M-MBEMBM-M-??---MM-BB-o-o----
-----o-?-??--EBo---?oB?-?BMB?-ooM?o--MB-MM-Mo-oo-??E-E---?-----B-M--BMMMBE----E--M?-o-E---EoBoBBB--oB---o-B-?-?o-?oBo--MB?M-o?-M-M?M----ooMM?o-B---B-o--B?-B----MEB-o-MEBMo?--B-oE?o-E-MME----o-BBo-?v--
E--MM--?-oMMEM-o--?BE??M-?--?EMEoooB--Eo-E--BM-Mo---M--o?-E-?EE-?-?oM?MEE-??-o??E--B-M----ME-M-Mo--?B--BB-o-o---BB?--M--E--E---??---M-?o-o?o---MM--E-M-o?BMoM--Mo--E-E-M?-E-B-oB--E-EM--MMoB-----BB--f--
Mo-o?-o-BBE-B-B--o-M---o?o-?MB-BB--o-----B---o----??--BoEoM--?---B?-MBE--MM---BEB-EM-??-o-----------E-Eo-o----------EB?-??-M-M-M-EM-------MB-M??B--B--oo---?MoB?Bo-?o-??-?MBE?ME?--EM-o-----B-?oB--M-f--
-oM-oB-?o-B--?oo---BM-MB--M-E?o--M-?Eo?-oB?----?-M-----M-M---oMo--?o----------------MM-E?B----MM?BB-M--o-oo?-oBE-M-B-EoEEM-?-E--MMM-?--o--?o-?-EMo--M-M---ooo--B-o-?BEooEo----EM---?B----?-M-o?-B----f--
---B---?o?-o-EEEMo-?ooEB-oB??--oE?-B-?oB-?--MB-??----o--?-?----EB-BB-??oBBoo---B-B-?-Bo?-?-o-oM-EB--B---oo?EBM--EMEM---?BEEEo-BBo?BMo-oE-B-B----?o-B---Eoo-Eoo--BB--o?BMM--?-MBo--BEB-MM-B--Eo----B--f--
M-B---?B-M-MM??B-E----BEMo?-o-o-M---B-?-?-B-o--?--EE-?-B-oM-MoMMoB------M-M---?--?-?B------T?-?----M--?M-?-?---BB-?EMB---B??o-BE?-oMB--?Eo-E-B-o?M-oM--B-?M?B--B-?ME?-?o--?-M?-oB-o?-MB-BoM-BT--?--o-f--
Mo?TM?---o?-T-T-T-EBT-MT----T-?-BB-o-M--oM--T-E-oB??--T---EET?---TE?MBM?T-BT?MM-oo--B-BT--B|oo----TTE-T-T-E-TB-TMTE?TBMo-o?T?oM?-oT?-BM-T-?--TB-------oEB-o?--B---M?-B?o-o?---o-BBT--BT--B--?|-B-?T--f--
mBM|-MoM--EE|-|o|M-o|MM|E-o-|BE-B-MEBB--?B-E|-B?-ooM?M|oB-M-|oEo-|-EMBo-|?-|-E?oEE--?-E|oBE|----o-||?E|?|oMB|Mo|-|--|-M----|?-Eo-M|-o-Bo|-?-?|B?B?oooMoMB--M-B?E-MBB?M?o-?MMMEBE-B|Mo?|-M?oBB|-B-E|o-X--
X----------------------------------------------------------------------------------------------------------------------------------------------------------------------------------------------------XXX
