--------------------------------------------------------------------------------------------------------------------------------------------------------------------------------------------------------
-----------------------------------------------------------------?-o------------------?X-------------------------------------------------------????--------------------------------------------X--------
---------------------------------------------------------------------------------------------------------------?------------------------------------------------------------XXXXXXXX-------M------------
------------------------------------------------------------------------------------------o----------------------------------T----------------------------------------------M---------------------X-----
-----------------------------T--------------------------------------T--------------------------------------------------------|----------------------------------------------------------------T---------
---------------------T-------|---------------------------B----------|----------------------BBBB---------------------o--------|------?---------------------------------------------------------|---------
-------------------X-|-------|------------------------------XXXXX---|------------------T-------------------------------------|------?---------------------X------------------T----------------|---------
------------------XX-|-------|----------M-----M--M--------X---------|------------T-----|-------------------------------------|---------------------------XX------------------|----------------|--------v
----------o--??--XXX-|-------|----------------T?---------XX---------|------------|-----|--------------X?---------------------|----------------B-X-------XXX------------------|----------------|--------f
----------------XXXX-|-------|------Xo----?---|---------XXX---o-----|------------|-----|-----BBBB----XX----------------------|-----M--X--------XX------XXXX---------o--------|----------------|--------f
---------------XXXXX-|T------|----------T-----|--------XXXX-B-------|------------|-B---|--------B---XXX----------------------|----------------XXX-----XXXXXo-----------------|----------------|-T------f
--------------XXXXXX-||------|----------|?????|-------XXXXX---------|------------|---X-|-----------XXXX------------------T---|---------------XXXX----XXXXXX------------------|-------o--------|-|------f
-------------XXXXXXXM||XXXXX-|----------|-----|------XXXXXX---------|------------|---XX|----------XXXXX--M---------------|---|--------------XXXXX---XXXXXXX------------------|----------------|-|-----Tf
------------XXXXXXXX-||------|------X---|-----|-----XXXXXXX--------X|------------|---XX|-------X-XXXXXX----------------M-|---|-----X-------XXXXXX--XXXXXXXX------------------|----M-----------|-|-----|f
m----------XXXXXXXXX-||------|---E-XX---|-----|----XXXXXXXXXXXX----X|------------|E--XX|X--E--XXXXXXXXX-----M------X--B--|E--|----E-------XXXXXXX-XXXXXXXXX-----?-------E----|-------o--E---X-|-|-E---|X
XXXXXXXXXXXXXXXXXXXXX||oXXXXX|XXXBXXX--X|XXXXX|XXXXXXXXXXXXXX------X|XXXXXXXXXXXX|XX-XX|XX--XXXXXXXXXXX----XXXXX---XX--XX|XXX|XXXXXXXXXXXXXXXXXXXXXXXXXXXXXXXXXXXXXXXXXXX--XX|XXXXXXX-X-----XX|X|-----|X
