-o------??--BB?B-?-o??-EMo--oEo-MB--o-EMB-B--oBB?B----o?--BoBB--o-oMo?-oB?-?--o-?o?----?MMB------M--?-?B--oo--M-E---Mo-MB?M?-?E?o-oE-Eo--?-?-Mooo-B?B??B-------?-o--?o--Eooo--?oE-o?BoM?-----o--o-E??-oo
----o----o--oE??--o-?-----oB-M-???-B-M--M?oo-B--oM--MM--oBEM-o--?-BoE-?M-BE-B?B-MooBo-?oB-B?M-o-E?oE?E?MoEM--?-?BM---E--Mo-Bo??o-o?-??BB--oo-B---?---E?BM?E-ME-B--o?o-B--?-M-???-o-B--oBoE-MEo-o-B-o?-oo
----oo--o-Bo-?-?-Moo?----BBE?-?B-M---o-?--?-?-Mo-M-MBo-?-??M?B-?ME-o?E-o-?-o-M-M-B-?MM-o--?---o--??-B--?MBM--oB-BE-o-?--o?M-Mo?--MEMMMo-?E-BoB-M??-Bo-Mo-B--BM-o-o?--oBB-M--o-B--oo-o?M?----MMEBM--?--oo
------?--B-??Eoo-?-BM--M?B-oBMoo-E??B??E-?ooE??---M--?-o---Bo?--E-B?-?BE-M?BoBo??o--o-oB--??oEBM-M?oM-M---M-BBE-EB?Mo?o-??BM?Bo-M?-?ooo-o--?B-B--o-oMMoB-Eo--oo?M---oB-BB-oo--o?-?BBEB-oMEM--o-o----o-oo
--?------ME--MB-M?-oMEE-E-MBMEBM-M----?BB---MB-M?o-E-?M-E-EooMMB--BE?-oB-?MoBM?M--M?MMo---oo???ME-?o?o?E?M-o?E---B??-?o--Bo-M-M---oM?oM----BM---ooMEMo-o-B-?E-o--EBEB---B--E---ooooo--??M?-B-?--?o-oo-oo
----------?MoMEo--oBMB?-B--B---B-E----?-B--M?E-EooE-??--?o?-B-?MBB---M??oo--B-B---oo-E-o-----o-M?o-o?EoB-??--?-E-MBBEB--MMM--?oo-B-oBoMo----oM-??oM--ME--B?BB???B--B--?o-oM-B?--M-?M-E?oo-M-?---EE--?-oo
---o--------?MBoE?-o-?o-??M-o---MBoo-ME-EoEMB?--BB--?M-Bo-M??BoMo??-Bo?EoB??E-MB?o?-oB-B-BE-MM?o?oo--????M---?-ME--o?-M?B?-?---BM??M----E-?-oo---MB--MMo--o-?-M?E--o-?B---Mo-------MM--M-BM?-M?--B-MM-oo
------?---EBE----MoM-??E--------B-?-Bo?B?-MMo-M-MEEoB-B--B-M?M--?-?-----EE-?M----M---Boo-?BBoE--?B?ooM--E?--o---BB?--MMM---M-M-MM---BM-??MM----Eo?o-B-MM-E--M----o--o-BB?B?E-?-o-E-E-----M--B?o--o-B-voo
--------ooM---o?oMoE--o?M---?BB?--o-o-?M-?o-ME-??BM-o-M--o-o--BM---MM-?B-BooB?M??o?B--?-BM--?-?-?-?-B--?--B-o?-?MM---?--ooo-?--?-o--??Bo-?ooB-MB--oo-?--MM??-?----o-?---EM-?-----BM?-MoB-??o-?---EoBBfoo
-----?---o?o-B?-oo??-oB--MM-EBoE--?Mo-?-o?o-oMME--??o-oE---?E?Mo-BB---E-o?-o?-?E-?--B-oEo?M-M?o--o----??o?MoB?---o-E-?Bo---?-o?oMBBM-?E?BB---MM-o?M--B?-BM-B--M-Bo?o?---M?-o-o??M?o-EBBB-MB-Eo-B-M-Mofoo
--?-----E--BE-?o--o?E-oo--B?M---Bo-B?-Mo-E-EM-M?-?oBoM?-o-?B?oo?BB?B-E?B?--B--o--B--BMoM-oo?oo---Bo-?-----o--?-?o-BMM--?---ME----MEooB--B---o?-?--------M?---oM??B-EEoBM-M?--Bo-o-o--M---B--??-M?-M-Efoo
-oo----------MMBo?BEB-?-o---?-BoBMBB-BM?o?-??----Moo-Mo--?Bo-o-B----?ooMo--BE-M-BBo-M??M-M-?M----?-??--ooB?-?-Mo-Bo?-M-E?o??M---B-?--E-BE-B---??MM--BMoM-oBo-B-MMMoM?--M-o?---M-?M?E?oEoo?M--MooE-MEBfoo
--------oBo-?oo-M--Mo-Mo-EEMo?-B--o-M---oMM----o--MEo?-o--B-B---?--o?-?--o-?--oo--BoMB--EEBE---M?EMMo?--?-?BB--M?MM-----o?-o---?-?o-?M??--B-B---E-oMBMBBBM??--o-MB-o??M-oM-E--B----M-MBM?-o---M???o--foo
---------?-oM-M---?----B?oB???-B-MEM-oEo--o--??M--o-o-?-B?-----Moo-Mo?-B-oME-M--EoMB-EE?--B?--o--oo--o-o-M-o-------o----oMB-Mo-oMo-B-?oB?-?-E?-oM?Bo--E--B--B-?-?o-E-?-oo?B-BE???-?o?oo-?--E--??-M-M-foo
m----------------------------------------------------------------------------------------------------------------------------------------------------------------------------------------------------foo
X----------------------------------------------------------------------------------------------------------------------------------------------------------------------------------------------------fXX
