-B??---?E?oo?--B---BoE-?o----oB---?o--BBBoBo-?M-?---B-B--M-??B--?o--M--BM-oM--BM-?o-??--BB-?-MoB-?-?--M--M?--o?E--B-o-?o-?o?--o-B--?M--oM???--BB-o-o?oBB-?-B?-oo-BB?M-E?-o-?B--M?oB--Mo-?--M?-M---?---oo
-----M---?---M--o---??MMo-??--?M-?---??--MM-o----o--?-B-----E-oBMo-----B?Mo-o-o--B-------M-?-o?oB-?--M---EE?--MBM-BEB---MM?M--B---B---?o?--MBMo--Mo?-M-EE-o--o?--E?-------B------o-BoMo-?-M?----ooo---oo
o------B-MM-oBo-M?-EB--M?--M------?-EEB--M?B---E-?--EE--M-B-B?---o--MBEE-?-M-?B?o-EB-----M-?-o?-M?M-B-oM-?M-oBo-BBMM-----Moo?BBo-B?--o---??o-E?M-?BMEo-B-BM-?---oM-oE--o-o-ooB--M?B?MM-o--??-----?----oo
?o--Bo--?-Mo--o-M--?-------MMoE------B--o--?------E-BB-oMM---B--?-MB--BM?MMM--oB?-B--MooB---?MBE?--oE-MME-----?-BB-M-?--B---M-B?-M--E-B-?B-oo--BM--o-?E?BBM---E-M-ME?BB?-B-MB?---B?oooMoo--MM--MMoBM--oo
E--M-o-oM--oM---?o?o-?oooM--EBBM--B-?--M--MB-BB-??B-MBMMoM-MB--o-BBE--?o---oB??-M-o-?--B?-MoMMEBB?--BM--B?----o-M-?Bo--M-B?Bo?-?---B--E---M-?---B-Mo-o--?B?B-?--B-MBEEo-MBE-Bo-M-M--?B--EEBB-oM-B-?-E-oo
M-BEo-o---ooEoEM-o---ME?o-M??---o-oBoM--Bo?---B-?---?oMEEEo--M--MBBM-M-oM--M-oMMB-B?o?------?-M-----E?--MB-o-?o--EB?--?BE------o---o-?-o---?---E-?o-?o-??---E-MME-B-M--?-M?-M-------??--M?oo--E?--MM?-oo
-B-M--M-ooBMMoMB-?BM--?-E-?-Mo--M-B-MB--o-B--oo-?--MMBBM-?o---E-B-----------MMoo?---EoEBB------o----MMo---M---E-B--BM-----M----o---M---??o---EE?o-?-?o-o--M-?o?-?B-o?--------ooM?B-?-Mo--o-?--M-------oo
---B-MoM--BB?-B---M----oB?ME---MM--B-o--M--o--M-o-oE--MB?o------o-o--oM?---o--B---M?-?-MB---oB---E-M-oB-o?o-----??E--oBB-MM-ooM-B--oEM-Boo?oM---Mo---?-Bo-oo?--o-M----MM-M-oBE--?--M---?E-oo--MB-----voo
M--MMo-ooo-BE-M-oEoo--?oMo-??--o?--o----Mo----------BE??----M---B-o-B-o-o--MME-BBBo-?--o?E--MB-BE-BB--?--MM-B?-oE-?MB----BE-M---E---BE--?Bo-B-BEE-oE?E-B?MBM?---o---B?-?M-BM-M-------oo?M-o-?o---?o?-foo
?-EB-----?---??MBB-EM-?-M---?-B?o---o--?-oB--o-?-B-B--M-oM-?-?-E-?-oE?--E--oB-o---?o?B-M---o-?oE---ME-?-o--oM--??-M-o----oBE-?M-----oM?-?--MBMoBBE?-BM-BM-M-Bo--?EB--M-o--ME?MM-B--M?o--oE---Bo-oB?-ofoo
--MMBE--?oooE--M-BBB---B---o-?oBM--??---B-?o-??----E-B?--B-----B-B--?-o?-ooB?-BEB--?--MM--B?---?o-?-M-BoB?-E-M-B?-B-?BE-M-?M?--M-?oM----oo---?--?BoMoE---oMBBB-B?-------BM-----BEBEE--oEEM-B-B-E-MoMofoo
M--o--EEE---?M-M-----oE?E-oMo--o-?-M-MB-?-M---oMM?oM-?-ME?-MB------B-o-MM-M---M-B--?B-------M--M-EBB-o--B-oM-?E-M-?B-M?----o---B--Bo-BE----o?-MM---oB?BB-?M-B?oBB-M?B-o-BooB--Bo-MMB--?-BM-----?-o--ofoo
----o-??----?EBEMoo----M-B-MB?---?-M--?-o-?-E-T?-E--?--EMoE-B--?------B-E--oBB--o-B-??Mo-------EoBM-B--o--E--oM-E-oM-M-oM?o?M-M??E---M--o-oB-BMM-M?--B-o----?EBE--B-EB--ME--E-o?---E-?MB--oBo--B--o-?foo
?-E-BTBT-ME-MTE?---E-BE-TT-oE-Bo----M-B?ME-MMB|-M?-M-M???---?o-----?TBM--EEM---T-?MB?o--T-B-MB?M-----oo-T????E--?oMM-oo--M-M-B-oT-E----?EoM-?o-T--MBE--MT-B--?-T--oB-?M--T?---T?----EE-o---T??----B-Bfoo
mBM--|o|MB?--|MMM-?-M-?o||-E-M??-M?E--?-------|MoM-EE-Eo???-E-M?B---|BE-BM-Eoo-|-?E-oE-M|oo-oMM-??--B---|oE-EBM----?-BM-B-oM-BEB|MMEB--E-?-----|M-oMBo?-|oB--B-|--M-EE--E|M-o-|-B-ooM-EM?-?|-o-Mo?o-Efoo
XXXXXXXXXXXXXXXXXXXXXXXXXXXXXXXXXXXXXXXXXXXXXXXXXXXXXXXXXXXXXXXXXXXXXXXXXXXXXXXXXXXXXXXXXXXXXXXXXXXXXXXXXXXXXXXXXXXXXXXXXXXXXXXXXXXXXXXXXXXXXXXXXXXXXXXXXXXXXXXXXXXXXXXXXXXXXXXXXXXXXXXXXXXXXXXXXXXXXfXX
