ooB-E-??-EMMoM-o---M--MM-oB-ME-ooM---o-M--B?-M?ME?--E-o-o-o?-MMo--B-o-M-B--oo?o-??MM-E--o-??-?B?-M-M--ooBM?-M-?------M--Eo--o-BoME--??B--EB----oEB-BE-?ooo--o-o-oE----?--B-o-?-B-?-?-------M--B---BM--oo
?--MMB?B--?B-EM-EME--o--Mo?----M-Eo--o----BB?B--B-E-M?--oooMM--oo-Bo?-?E??----B-EMB--MM?--E-B?-oo--BoM-E-B---o---BM---B??E---M?o---?o---MME-o-BM--o?M-M-M--o?-B---oM-M--??B-?-oME-o---o--?--B---M-?M--oo
M-B--o---B--E-o---MM--ooM-M--o?M-?--?BB?Mo??---Bo-Mo----MoB-oE?--Eo-o--?EE--oBE-M--o-MBEo??--o-M?-BM--EBBo-o-B--BMM--?---M-o?--BE?-B-o-?-?MM-ooB-BE?B-oMM-o--o??-?B-E?E--B-M-E??B-B----E-?---Eo?--?---oo
--EB?-B---Bo--Mo?B----E-----M-?B?o-?--E-?M?-?B-----E?--?EooB-M-o-?M?BMo-M---EE-Eo-o?MoMMMME--?o-----BoMB-M----MB----oEBo--E-MEE-?--oo--oEE??---MoBMMME---M--B--ooE--?--MMM--o-ME-?E?BEo-M--B--M-o?M---oo
oM-o--M--?--o-M----B-EME-B----o-----B-?-?--oM-?M-o----oB-M?EB?BB-??---M?----BM-?--EMo---?MB--?o-oo?-??----o-E-M--B---?-o-oMB-B?--E-o-Mo-M-o-BB-M-oMM---o--?o--oMM?o---MM-MBB?-??o-?--B-------BooM---B-oo
-o?Bo-E-M----M-o-o---BoB-MB----o-o??----oBB??-----?MB-?-----Eo?o--o-E---M---o?EM-----Eo--B-o?-B-o-o---EB--?-B?oM--?-M?--??BEo-B--??-?-------Bo--?-?-B--M-?-?-o--MM-o-o?-BB--?--Mo---?BMoEM?-M-oo?-E---oo
---EEo--oo---EB-M--?BM-B--o--EE-E-M?-B----B---B?-M--?EEE-?----E-o-?B---BM-?---BM-BB---B?o?oM-M-o-B-ooMMME?-E--B?-Eo--?E----?o--?E-MB----o--EoM?-?MoB--E-?B-?--M--?B---M--o----B-o?Bo---MBooB---?-oB?o-oo
ooE-?M----B--?-oBB-BEB-M-oEB--B-M---B-MoE-??Bo------B-M--?B---B?-B?BB--EB-?----o---M-o----B?-M-o?-o-B--o?MM--Mo-?--o--B?MB-Eo-BMM-E-MB-B--M--o---?oB-BMEB---?M?EMoM----MEB-B--o?---??M-MM--------oMEMvoo
-?M-Mo---?B--B?--B--M--E-BB-M-BB--M--?ME-M-----MM---E-o--MMM-BEM-BME-B------BB?o----Bo-E?M---------?--oE--M-o-B--B-oE-MMB--BB-?--oBo---o-?Bo-ME----?-M?M-E-o??-M-B?B-o-BMMM---M---?-E---?M-E--B-Bo??Bfoo
E-M-------MBMo-o-?E?B-E?--?MM-BooM--ME-B-----oM-M---M??o--o-M-MEo-o-?----EM-MMM-???BEoMB----M?oMo---?--M-BB-EM--B-oE---ooo-?-o----BM-EM-BM----BB----??-o-M--E--?-MMM???--B-B--BEM--M--MB?MB?-?-oM?---foo
?o?B-o-B-Bo------B-B-o?-E?E-EM-B?-E-BB--B-o---E-o-o-M-?--Bo-?o--M------M??BMMo?M--EoM?-o--?oMM--B-?-o-EEE-M-B?-E---?-BB--oMM-E---ooM-M---BMBB-BB-?----Bo?-M-?--o--?-o-MMMB-BM-B--E----o-?-?B-M-o-?-oofoo
MM-o--o-B--EEB-M-E--B-?o-B?BB-E--??o?---Mo-M-M------B----??---E?---BMM?oMM?---o--M?o--o---MBo-?-ME-?-M-M-M--o-oB---B-E?-o-B--?---------BMMooMT---B-M---BME--------?B-E-o--------M---?M-?---?o?---o-oofoo
-M--BB----oMBM-BB---M--M-oE-o--oM--B?--o-MB-o-EM--o?---M-E--MoBBo---EE--BM?BM?--oB-M-ooB-BBB-Mo-M--B-o--oM-o-B--EM---BM-BMMoo---?o--MMM---?MB|-o--M?-o-o??o?ooB-T?---?---oo--------?M-E--B?-B-ME-----foo
-TEM----T---MB---B-TMo--T-M-T-ME--BB--E---ETEM-To------T---Mo---?T-T?--oo--o-M-T?o-B---?B-oM??--oM-M-ETEooE-M-o--Mo-o??-?---T-o---?TB?EMM---?|o---M-o?MoM-MM--oE|-E-M-o-MToTTMoBE?EoMTT?---BoooMM-?--foo
m|ME-oM-|oEoEB-----|-ME?|---|M--B?--M-?-Mo?|-o-|ME-oo-o|--ooB---B|?|MoMoBMB?--o|E-M-oo--??E--?Eooo?o--|?-BBE-?E---Mo---??M--|E-M?E-|ooB--M?--|--B-EM-E-B----M---|MB-?M?EB|B||-B-M-?oE||-E-MM-E--M--EEfoo
XXXXXXXXXXXXXXXXXXXXXXXXXXXXXXXXXXXXXXXXXXXXXXXXXXXXXXXXXXXXXXXXXXXXXXXXXXXXXXXXXXXXXXXXXXXXXXXXXXXXXXXXXXXXXXXXXXXXXXXXXXXXXXXXXXXXXXXXXXXXXXXXXXXXXXXXXXXXXXXXXXXXXXXXXXXXXXXXXXXXXXXXXXXXXXXXXXXXXfXX
