oM--EME-Bo-E--M--?-?--E-MoEMo?--M-M??oMM---?EE--o-?oE-oo-BEoM-BEEM-oo-B-o-EM-o-oMBMEE?-M?B??-oo--MB--oo-o---B?B-----B?M-EB--B--B-Mo?o?--oBE----B-o-M-B--oE-?BM-??-----M--B?EE-BM?---MM-----BoBo-E-?BoB--
?-----?---BMMBM-?oM--BBE--Mo-M-o---?-?----oE-B--?E-----?-oMBBE--?o-o--o?Eo?BB?-?-EM-ME--?-o-B?B-E-MB-BB-M--?M--o--BE-oMBM-??-oE-M?Mo--E----?--M--BMM-M-----??MBB----M---?o?-MB-?o-M-Bo---EoBo-E-----BEM-
-E---EEooEM--?-B-------M?-MME----?o---M-M--B--o-M--M--oo?--Eo--M-BB?M-ooB---B-E--ME-M-Eoo-BBMB-?BB-MB--B-B?M?M--o-EB-E---MM-o-???-B--B?---B?oB--Bo-?BE-o-?M------M?---o??-oo---B-o?--E--?MoM-?BBB--E--?-
BM-EoB?B?-o?----E?MMo?M??M--?o--MM---oBoM-MooM-B-?-MB-o-M?o-B-o-o--ME?-M?E?--o-?-BMMM--M-o---oB-MEo----o--BB-B?--o---M--M-?-??-M-EM??--oEMBM?-o--oM--M---MM-?--EB-EM----oB?-M---ooMB--o----?M--o---Bo---
??---B--BM-MEE--BBB-o?---?-oB-ooEBoMo--E-oMoM--Boo-MB?-M-o-?o?E?--E??o------E-M?----?o-o-E----E--------M-EE-?oM-----E-o-M--E-BE?--B-B--B-M--MB?o?B---B---?oMBoM?M-BE--?EB-B-M---o-EM-Mo-M--------B---oo-
oEM-EoM------B--BE---Mo----oMBB-BBM-?-oB----E-B-?M--o?--MMo---?------oo--?----Eo?oM--o---?--o----?-------?-?M--MoM--B----M-B-BM-oM-?--B-----oBBBBo-M?-M?MEEMM?E--B-Bo-B-MMo--M-B-oB--E??-EB--BB-Bo---M-M
M---B?--M-M-M--BMMEBE-o-BBoB-ME---EEBE--E-M-B?-?oE?-E-?-B-MME-o-E-M?--BE-E??Bo?E--M?--M-oM????-o-o-M?oE?-M--MM-M?-EB--M-BMo-o---oEMo--EMMEoM-oo----??oE-B?-oE---Mo?MM--oM-B--oMB-M?BBB?E-?B?oEEB-o-ooM-B
----oE?-oMBMo-?BB--MB?o-B?oBo?--M??B--o-?-o-M-Eo-?--?--o?BE------o--M?o--B?-Bo--?o-?----oBM--?E-------Mo---M-?-oBEBo--oB??o-Bo---B---?-M-?---o-?---??o-?--?E--?--M-M-EM--M-EoB-?B-?--B???-o-M--?M-?M-o-v
?ooEMMEB--o-BoM----BB?--o---BBM---M?B--o----oE-B----?Bo--EM-EM??----oMB-B--????EME-?--o-M--oo-MBE?oMEMMMoM?oo--o-----M-o-M-BM?-?---E-----E-BBM-B-o----E----???o-o--B-?BE-MBBo?oE?o-E-E-B----E--oB--ME-MM
-B???oB-o--ooB??o--M--?-M-B-o---o-B-B-M--?B--?--B?B-BM--?B--------M-MM---B--MM--MB---o--Bo-BEo------M?---o---?B--oo-oE-M?M?M----B--ME---EBoo-E---?--E?-B-----BE---BE-oBB-o----E--o-B--BB---oB--EM--B?MB-
?--E-E-E?-o---------MB-?-B?B-M--B--MB---oM-oo-----oo?-B?M--M-EM--M-o-BEo?-----?--MoE?o--oo----?--?-o?oooBE--o---?-??-M-?--B--o--o--B-B--BM?-E---MM--BB----oB---o--B-----Bo-?ooMB--EEoEo-MMM?---B?o--o-M-
M-MM---M--M-?----E--?-------EMM-ME-M-oo-MoB-EBEM?-o-MMB-B-oE-??-?--oM---M---BBM-M-?BMo-M---?B---o-oB--MM?-M--M-M-o--oEM--?B-BB--M-o--?----B---MBo---MB--o?MM--B-o--ooBB---BBEo-o--MMB--?-M?---M----B?-B-
o---?BoEE-B--E--E--B--EE?--o-B-M-?B-E-BM?-----?oM-o--BoB--BBEMo--E--ME-BMT??--M-B---E-E-MBB-o-Eo?M?E--B--oMM-MM-M-----MEo-?o-Mo----EB-B--?--E-?-M-?--?-ooB-B---?-B-?----ME-MM-??MMM-?BM-o-M-E-M----BBBB-
-?o?E--?-???oTE?--o?B-TTToT-BMo----EM-BoB-TME-EB-BMT-T-BMETTToT???MEM-T-B|?EBoB?M-T-B?--TT?BBMBM?M-?M?-oB-MM--M--M-M-EB-B--T-Mo--?-?-E-BMT---M-E-BE-oMo---o-B?E---B----oTM--Eo-----B--Mo--?MM-T---T-B?oo
moMo--?B----B|-o-?M-E-|||o|M?E-?-oEB-?--BE|--BME---|M|oM?B|||B|-?-----|M-|BM--E-?-|-B-E-||BoM--BE-Mo--E-?EB-BE-BEBBEoMB--?o|--EM----?M--o|o-M?-MB--E--E--E-EME---?BEE-?E|?B?MB--?E---?Eo?MEBEo|-MM|Eo-oo
XXXXXXXXXXXXXXXXXXXXXXXXXXXXXXXXXXXXXXXXXXXXXXXXXXXXXXXXXXXXXXXXXXXXXXXXXXXXXXXXXXXXXXXXXXXXXXXXXXXXXXXXXXXXXXXXXXXXXXXXXXXXXXXXXXXXXXXXXXXXXXXXXXXXXXXXXXXXXXXXXXXXXXXXXXXXXXXXXXXXXXXXXXXXXXXXXXXXXXXX
