--Bo-ME---?-?--MM-M--M--B---?-E-?BoB--o-o--o-Eo--oMMB-M--?o?B-B-M-o?B--oE---E???EB-o-E---o-Bo-o--E--?B-B--ooM-B-?Mo?-?--Bo---------B?BMB---oo?-BB-BM-M-o-BB-----B---?-MMB?Mo-B-o??-BM?-?MB----B?E?oM--oo
-EBM-?B---M---?----EM-M-BM--B?M---?-?o?EB-??M-EME-M--?--oo---B?E-MB--E--B----BM?ME--BM-E-Mo-?E-o-B--M--E?M-o---EoB-B-Bo----B-oB--oM-----EoE?-Mo-E-B----M---?BBoMB---Mo--M-M--E--B---B---E--M---M?--MB-oo
M?E-?M--Eo--B-MB-B---B---BM-?-o-oo-MMM-Mo?o-o-BMB-----M-MMoM??o-----BM?---BM-MB-MBoE-?---Bo--M--o-BoEo-?-??--ME?B-?-?---?--B---?---Boo-----B-?B--?E-----?---Mo-?E-o-------??MM--BBMo-EEo?o----?---?---oo
M?B--B--BM--?-?--oMEM-B--oE----?--?-M-?--oM-----oM---oo----oo--ooM??B-Mo---E-?o-MM-B-o-EBE---?-BMMooME-??---o--ME-Mo?B?EM-Mo-------oEBE--E--MMM-B---EB--B----?-B-oM--B?ME?Eo--??--B-?-?o-B-o-----BM---oo
-MM-?-M---?-oB-B-?BB--MBE?-Bo?M--?---B?-o--??MB--E-oo-BM---B--E----EEM?Eo?-B---o?----M-?BMM?---oEo--B?--o--oE-----oB--?--BBoooBM---B-BM--BM---oE----?-B-EB?o?oM--B-?-E?-?--o?-??M---B?oBB---E-?--oM---oo
--BEMMoE-o-Eo-MB?---E--o?--M----M?oMo?o--M-BBo----ooE-?M--o?EoMM---MME-B?-o-MB-E----?-??-B-?BMo------M-oo------?B-?-BMo?-o?-EM?o----ME?o-oBo---?BoB-?---Mo-M----?--M-B-o---o-o?Eoo?o?o------?-o-?-----oo
--EMo--B?B--?oo-M--M----BM--M----BMEM--E-BMEMM--?-BE-------?------o---------?-o----o-------?M?---o-B-??oo---BB?-----o---??-E---M----EM--EM-M-???-o--E?M-o-MM----o----?---E--oMB-----??B-----?o??M--?--oo
--?--?-oB-?BMB---o---oMo----M-Mo?E--B-M?M?-M--BME-o?MoBo?MM-BEE--B-BEB-E--M-E-B--B-o-?--EB?---o-B---?-??Bo-?Mo------?Mo-B-o-----Mo?-MB?-M?--ME-M-MM--MoB--Mo?-M---EMEBEo---B-o----o-??B----oMoE-B?--ovoo
--B----o---o-M--o-E-o--E--?M---?o-Eo--oB-o-MBMBEB-?E--EB-----B?-?-oBB------B?---?o?MMo?E-?-?M---EB--o--o--M-M-M---o?--?oB--M--??Bo-Eoo---MB-?---M---BM-MB-MEB--M-MM--MB?EM--B-E?-?MMo--?----M??---?-?foo
M----?EM?--M--?-B-??--?-M-Mo-o-ooM-?B----o--?--B-??BBE--M?--B?-BM-ME---EEMo-Boo-B?-B?-MME-o-E--oB-B--o---?--o--EM--o-B-MEo--M-M-BoBM--M--M-o--?--M------M--B-M--o--E---BBo?--?B-E--M-o-B---oM-B----o?foo
B--?E-?-------E?B?--BBoME?-ME?E-BB?--M-?--?-?E?---E?B?BM---?--?--??B---BM-?-----M--B?BE-B-Eo---M----M-Eo----M-oBo?B--EoMM--o-MM-?o-?-----?----?--EB-o--EBB--MB--?-BBM?-?oBo--M-M?-oMo-EE?o--E??Eo-o--foo
oo--M-?oMo-B-BM?-B---E--Mo?-------??Eo-o-M?MM?--M--M-o--?----M-----MBo--M--B-oE?BM------o-?---B---o--?B---EE--EE-MEoE?o-?BMoo-MM----------MB--oBBMMo----o?-M-M---oo--B-M??--o--oB--o--B?E?o-BBo------foo
B-?-?E-E-o-M-BB--o---??E-EMMoBo-oB-E------o-?--B------Eo?MM---?---?----o---?--MME-ME??B-?-T-----?-B-o----???---BBM-M-oEMBEo?-B-Mo?oB--E----o-BM?---B-M--o?-----o-oB?---MoB-MoB---oBo----?M-o-?--?oM-ofoo
M-o-?-B-T?--?o-B---?-M-?---o-oB-??-?--------B?oT--BBoMT---?MoEB---E---o---o---T-T--B--M-To|-o?B-?M-B-M--------MB--TooE-?-T--o-oB-M?o?-M-?M-ToM-T-o--oT--E-MTE-EMM-EM-T---T----Mo-MB---M-BBTTo--T--M--foo
m?E----E|EB-oM-B-B-M-B?oB--B-?Mo-o-B-?M-EEMoBE-|B--M-?|EE--MBM?-??MM?--?oo-MMM|-|-oM-B-E|-|o-o---ME-oE--o-EoEoEMMM|B?BM?M|M--??MBE---BBMM-B|?Mo|B-MoM|E--M-|-o-EME-oE|--o|oE?BM-oEMEB?oBo-||B-E|-M--Bfoo
XXXXXXXXXXXXXXXXXXXXXXXXXXXXXXXXXXXXXXXXXXXXXXXXXXXXXXXXXXXXXXXXXXXXXXXXXXXXXXXXXXXXXXXXXXXXXXXXXXXXXXXXXXXXXXXXXXXXXXXXXXXXXXXXXXXXXXXXXXXXXXXXXXXXXXXXXXXXXXXXXXXXXXXXXXXXXXXXXXXXXXXXXXXXXXXXXXXXXfXX
