---------------B-------o------o------------------------o----------------------------------------------------B-------------------------------------------------------------------------------------------
-------------------B---------------------------------------------X---------------------------------------M--X-------------------------------------------------------------------------------------------
----------------X-M---BBBBBBBBo-----B---------------------B---------------------------------------------------------------------------------------------------------------------------------------------
------------B---o-M--B---T----------------oT------------o---------------------------------------------------------------------------------------------------------------M-------------------------------
---------B-------T-MXT---|-----T--B------?-|-----X----------------------------------------------------------???????---------------------------------------------X---------------------------------------
----------?M-----|---|XBB|---X-|--Xo-----X-|---------T------------------------------------------------------T--------------------------------------------------------X----------------------------------
---------X-----T-|---|--X|-XXXX|XXX-----XX-|---X-----|-----------?-M----------------------------------------|-------T------------------------------------------------XX-----------T---------------------
---------TX---X|M|--X|T-X|-XXXX|XXX----XXX-|--XX-----|----o-------------------------------------------------|-------|---------------------------------------X-------XXXXXXXX------|--------------------v
---------|XX---|X|--X||-X|XXXXX|XXX---XXXX-|-XXX--???|????-------------------------------------------------T|---B---|-X-------------------------------------XX-------XXXX---------|-------------X----??f
---------|XXX--|X|BoX||-T|XXXXX|XXX--XXXXX-|XXXX-----|-----------------T---------XXXXX---------------------||-------|-XX------------------------------------XXX------XXXXX--------|------------XX------f
-------X-|XXXX-|T|X-X||X||XXXXX|XXX-XXXXXX-|XXXX-----|--??o????--------|----X------------------------------||----X--|-XXX-----------------------------------XXXX-X---XXXXXX---?--X|-----------XXX------f
---------|XXXXX|||XXX||X||TXTXX|XXXXXXXXXXX|XXXX-----|-----------------|---XX------------------------------||-------|-XXXX---X------------------------------XXXXXX---XXXXXXX----XX|----------XXXX---M--f
---------|XXXXX|||XXX||X|||X|XX|XXXXXXXXXXX|XXXX-----|-------X---------|--XXX------------------------------||-----X-|-XXXXX-XX-------------------o----------XXXXXX---XXXXXXXX--XXX|---------XXXXX------f
-------XX|XXXXX|||XXX||X|||X|XX|TXXXXXXXXXX|XXXX-----|------XX---------|-XXXX------------------------------||-----XX|-XXXXXXXX---------------X---------X----XXXXXXX--XXXXXXXXXXXXX|--------XXXXXX------f
m---EE---|XXXXX|||XXX||X|||X|XX||XXXXXXXXXX|XXXXX---o|-----XXXE-----E--|XXXXX------------------------------||--E-EXX|EXXXXXXXX--------------XX--------------XXXXXXXX-XXXXXXXXXXXXX|-------XXXXXXX--B---X
XXXXXXXXX|XXXXX|||XXX||X|||X|XX||XXXXXXXXXX|XXXXXX---|XX--XXXX----XXXXX|XXXXXXXXXXXXXXXX-----XXXXXXXXXXXXXX||XXXX-XX|XXXXXXXXX-XXXXXXXXXXXXXXXXXXXX----X----XXXXXXXXXXXXXXXXXXXXXX|XXXXXXXXXXXXXXXXXXXXX
