--------??o-BB-B-?o-?--MEMo-??oEo??o?o?ME?oB-?EB-B-E??MMM?B--oo-B--M-o--B-MB?oM-E?M?--oEM---B?-MEE--??ooM?BM--o----B?-?-?--BoEoo-ooE-E---?-?-Mooo-B?B??B-------?-o--?o--Eooo--?oE-o?BoM------o--o-E??-oo
---?o-------oE??---B-MooB-BBo-M---BM-EB-Mo?E--B?o-oM--?M--oE-oM-o-BEB?-B-MMB-Eo?-?B----M-oo-oBB?--o--o--?B--o?EM----?--?-?-?-?Eoo-?-??BB--oo-B---?---E?BM?E-Mo-B--o?o-B--?-M-???-o-B--oBoE-MEo-o-B-o?-oo
-oo--o----Bo-?-?--o?M-oo--oB-ooB-----M---?-?-Mo-?---EB-oB-?B-o?-M---?o--MMMo-M---BB-?ooBE--o---E-BBBoE-E--M--o--???---oMM---oBM--BEMMMo-?E-BoB-M??-Bo-Mo-B--BM-o-o?--oBBoM?-o-B--oo--?M?----MMEBM--?--oo
------?--B-??Eoo-?-Eo-MMM-M----Bo?----E-MEo-?-E?--MM??o?-o-M-ooMEoBoM---M-B-EM---?-B-?--Mooo------o??-B--ME??M?-MB----??-??oo?ooEB--ooo-o--?B-B--o-oMMoB-Eo--oo?M---oB-BB-oo--o?-?BBEB-oMEM-oo-o----o-oo
--?-?--o-ME?-MB-MMEB-?EB-??M?E-oo---?MBo-?M-oB-BMBB-oB--?---oMB-M-o??-EoM?B--Bo-M??Bo-o-M-E?-o-BBBM-E-oM-----M-?ME-Mo-M---MB?M-EB-oM?oM----BM---ooMEMo-o-B-?E-o--EBEB---B--E---ooooo--?-M?-B-?--?o-oo-oo
-----?---o?MoMEo-o--EBMB?o--MMo?oMB--o--B----BBMo-E--?-EM--?M--E?--BEM-?---BB?-E???M-o-?Mo??-Bo-?M---------BM-?--BoMMEB?-B--oB-B?B-oBoMo----oM-??oM--ME--B?BB???B--B--?o-oM-B---M-?M-E?oo-M-?---EE-o?-oo
------o------MBoE-?o?o-M--?oM-?---oMME-M-o--M-??-E---o?-?o?o-M-?ooBMB--oB??oMo---?-oMM?B-?---?-MBM-oM--o-?---o--B-M?-ooE--o---B?--?M----E-?-oo---MB--MMo--o-?-M?E--o-?B---Mo-------MM--M-BM?-M?--B-MM-oo
------?---EBE----?--B-o--B-?--M---o--M---E-?EoM-??o-?---B-BM------Bo?-B?-??-?BMB?o--B?oB-E??oo-B-ooM?-E-Mo?B--o-?M?-?o--??oooB-?M---BM-??MM----Eo?o-B-MM-E--M?------o-BB?B?E-?-o-E-E?----M--B?o--o-B-voo
--?---?-ooM---o?---BB-?BE-?M-???--o--E?-?B-BM--Mo-?-?B-BB-M?o-B----o-Mo?-o?--BoooMo?-BB---EM--o-E---M??B--Eo?--?--??-oM-??--BBBE----??Bo-?ooB-MB--oo-?--MM??-?----o-?---EM-?-----BM?-MoB-??o-?---E-BBfoo
-----o-?--?o-B?-oo-??o-B?oo-?--BE--B-?-?-B?BE?-B-??MooM-B-?EMoEo-M?E-oMo-M--EBM--?oM----Bo??oBBM---o--oM--B?o-oMB-M-M----?-oME-?oMBM-?E?BB---MM-o?M--B?-BM-B--M-Bo?o----M?---o??M?o-EBBB-MB-Eo-B-M-Mofoo
--------E--BE-?o---oM-E-?M----o-MB?---oo--o?Bo?-?oM-o?o-BoBMMM-----o?-o?BM--BooM?-o-E-BE?-Moo?-o-o?-Bo-?o-E?--o-o?Booo-B?E---M-B?oEooB--B---o?-?--------M----oM??B-EE-BM-M?--Bo-o-o-oM---B--??-M?-M-Efoo
-o-o-------o-MMBo--?--?--o------oM-o?oEBo?-BBBo-oM?Mo-??BB?EoB--B-M-E-?-o--B-M--oM?-?o--M--oE--o??--BooMo-M-E?---B-?-?-Mo-oB----?-?--E-BE-B---??MM--BMoM-oBo-B-MMMoM?--M-o?---M-?M?E?oEoo?M--MooE-MEBfoo
---?----oBo-?oo-M----B-E-BoMM??---?----?-Bo?M-Bo?o-o?-E--E--o-Mo-oM??-M-BM--?o-----B---o-?Eoo?oM-B---B--M---o-B-B?MBo----?MM--o-----?M?---B-B---EooMBMBBBM??--o-MB-o??M-oM-E--B----M-MBM?-o---M???o--foo
------o--?-oM-M--?M-o-B---M-o-EE-B-?-?B?-B-?B--?o-?-ME??--?E--o--E?-?-EBM-o-E-?B-BB----?-E-M-o-o-E--B--EB--oM--MB?M??o-------o-----B-?oB?-?-E?-oM?Bo--E--B--B-?-?--E-?-oo?B-BE??--?o?oo-?o-E--??-M-M-foo
m----------------------------------------------------------------------------------------------------------------------------------------------------------------------------------------------------foo
X----------------------------------------------------------------------------------------------------------------------------------------------------------------------------------------------------fXX
