E-EM?o-MB-M--o-o-?-o---BooM-E-B--oooB-o-o-oE-B-?-Eo--M--BBB--?------?M-oEB?-?Mo-?--B-?M---o-o-??M--MEMBo-?M-BB?BM---Bo-B-o-E-MMEM-M-oo---B-o?BM-o---o??--?M-?BoMBoE?E-B--MMEB?--BB-M--E?B-??BBo----o--oo
M--E---Mo--BE--Mo??o--E?-B--ME-B?---oM-M-M-?oo-E-oE?--B--Mo-o-------o--MB?o--M---Mo-?o------Eo-M-o?E??-o?M----M??-B-B-oMMEB?BBo-ooB--?MB---M--MBMM---?---M-o--o--MM-BM?Eo-B--BB--E--?o-M?oooBME?M---o-oo
B--?B--?----M?-oM?--o??-??-?----?M?M?Mo-M-BE?-??oMBBo-E??M-MMEM---MMMBM-MMB-BMoBoB---E--M?M?--?-oM?BB---MBo--M-oM--o--??o?o?o?-----ooM--???ME--ME-MoEMo-M??o-oEM-------?-BBM-B-E-Moo?-----oM?oM?-oBMB-oo
BM--B-B-?-B--oE?-B?o-?--EEo-?-M?B-M---B--o--E-?-?-M--oB----o-B-o-Mo-o--Bo?----E?--M-?MoMMM?oE-BM?-M-o?o?-----oMo??Eo?oo----BBo-M----B-o?-B-?--M--M?---?-M?o--?MM-E-----BMEoM-oB?MBM--M-?-oo?-----EM-o-oo
Mo--?BMo--o-o----MMoE-?-M??-------Mo------?--?o--o?--E-BoM--o-oo-oM-o-o-B??EM---M--BoE-----E?-B?EB-?--oB?o-?--MEo?oE-?-Mo-???---M---M-Mo?o-B--B?B?B-o--M--oB-??--?M?M??--?-M?-M-BB--o-?M?-?--E?oo--?--oo
Bo--??--M-MM--?BE-B-?BMB?-M-?-?-oo?Mo?--o-BBMoMEE-B-o----EM-M--Eo?-----M-?M-oM?-BM-BBM--Mo--?M----M-B-MBo-B---M--Bo--?--MM---EB-B-----oBM--oM-?M--??o---??B--oBM--BBE--M-Mo?-ooo---o-M??-Mo-o--o-MB---oo
oo?-?o?oM-Eo-M-EM-?ooB--E-B---oo-E--E--?Bo--M-MoM-M?------o-M------o----???E-o-o-oE-o-------oBM?--?-oB-Bo-oMEEBM?-o?-??M-MEoB-o-oMoBo-?--B-B?---oB--MBo--oBE-ME---M-M-o-???-M-Boo-o-B--?---?-o-o-B-oE-oo
-B?E-B-Bo---MB-B--E--o--Mo?E-B--EM-EME----o-M?BoBo-B-?M-------BoBME-o?Eo?-E?E-M-B-?--Bo?--M-oE-BB-?-B--o?--B-MoooE?E--o----?-B--o--???o?-M?oEoMEM?-E-E-Eo?-?--?-E-oB-oMMBo-oM?BooBB-EEM?MM-EE-MB?---Mvoo
-B---MM--?M?-E-B--B-?ooEMM--o?Bo-----Mo--E-?M--B-o-----M-o-?Mo-B?o-Mo----?B--??ME-o-oEEoB-?-??ooMoEBBMM-B-B---M--?-?B--M-?E----BoEo?o?--o-B??-EB---M-?MBMo-Bo--o--oM-?-MMBM?B-Mo?-o-?M--M?-M?oBMBMoBMfoo
-MB?--B?B-----M-B?---oEM-Mo-?MBMMMB-ooBo???-o?-o-o--o?o----o?---E-oo??o?--oE--?o?M-BM?M?-o-E-EoM?MBBE-E?Eo?-Eo---M-M-E--o?B-?-oB---BBB----?-B-M-M-----B---o----EM-?--BMEB--?M-MBB?B?oooE-?-o-----o---foo
---M-M-E-MEMB--B-?-oE----?----BM-o-o----o?E-oo?M-B--Bo-MoM-B?-----B--oM----B-?-B-oM?---oBo-M-M-oBB--?M-B-BM-?E-BM?EMM?ooM-o?-?EB-ooME-oM-o--oE--?o-?---EM-oo--EMB---?---BEMBBoEE?-BBBM-oMoEoEoE?-BoE-foo
o--?-MB-BoM-------oBM-E-o?-?E-Mo-----oEoEoMEo?--?M----oM?-MB--E---Eoo------o--BB-??oMoo-oM-E?M?E--?----EBBE-----B-?--?-?E-EM---MMM-?B?-B-?-B----o-oBoMB--B-Bo-----Mo----EB-?MMB-B-?MBo-o-M-E--BBo---?foo
Bo----oB?MM-E?----E-?BMB?---?-??--EM-BB?--o-M-o-?-oM---oooEo-BM--M-MMo--o-Bo--o-B?BM-M-M--?-?-?-ooBoo--B--?M-M?-?--MB-MoM-Bo-E?---?oBMB?o---?-BMM-?MM-----Bo---B--EMMBo--oEoM--o--?-B-o-o--??-BMooB--foo
---MTo-B-------?--M?oMBB--MoBMBBE-?------T---E----?-?Mo-T-B--BTT--MBoBTo-M?---M--oM?o---M-M-o-oMM---?o-?-E?o---oM-o?ooTE--BoEBTT--oM?oBoTo?BB-o?---M-?M--o-T----o?M-oT----?--M?ET-?o?----To--B--?-M?-foo
mBB-|oo-o-M-BMMBEoB---o-M-?MBE-?B-EEBoo?-|B?--?B-EEBoM-B|ooo-M||-?o?-?|oo?EE-B----o----oM?B-BM-o?oo--BMBEBoo-o-M-oo---|B-??Boo||-?EM?MoB|?o-E?MM-oEM--M?--B|EM-?----M|oBM--?-EM?|oo-EMo-E|?M?E----B--foo
XXXXXXXXXXXXXXXXXXXXXXXXXXXXXXXXXXXXXXXXXXXXXXXXXXXXXXXXXXXXXXXXXXXXXXXXXXXXXXXXXXXXXXXXXXXXXXXXXXXXXXXXXXXXXXXXXXXXXXXXXXXXXXXXXXXXXXXXXXXXXXXXXXXXXXXXXXXXXXXX----XXXXXXXXXXXXXXXXXXXXXXXXXX----XXXfXX
