M------B-BoME----o--o-M-E-------EMB-B----EoBBMMM--B-??o-----oo-Bo-o---M----ooE-B-Moo--?---B---E-?-?-?--o----?-oE--o-----o-E-?M---o--BoBoMMB??Boo-o?-?B-M----?o?-o?-B?oM--o--B-?o-?--BB-o-BM--EEo---BM-B-
M-Eo-E-o--E?M---B--M-M--?oM----M--oo?----M--M--B-BBoMB-o-B-M-M-?E-E--o-E?E?--M?-o-o----o??--MMB-o?oo-o?B-?------M-B?-M--oM?-M--oo--?-M-?-?M----Moo-BMMB----M?B-o-o--M?-M-E-M--oBE-?-o?-MBM-oMMB--?M---MM
oBBoo-?-MoMBoE?-MM--B?B?-------B-M--oE---M?M--B-o-o?oB--o----?E?M---B?EM-?-oo--MEBBBo-?M?-oM--o-?oo-??oB---?BM--?--B-oMBB??-B-oB--B--MoB?--?----oo---BMB?-EMM-E??Bo?E-MM?--B-?--BMMoo-o-----o-??E-MEM--o
o?-----------------M-E--?B---MBoE--E?----?-oE-------Bo-oM------B-?B--M--M-------BMo-oE?o?-?EMMo-oB--------M-E-B?M-M-B--?M--MB?-??o?-B?oB-MM---?M----o-M---B--o-oBB-BM-??MM-M--MB---------B--B-oM?-M?E---
B-BE?M?EoE---o-------B--?-o?-o-B?EMM-MM-----------ooBEo-BM--EB-BE----?M-oEB--ME-E??EB-??ME-MEo?---o---oBo?----?-?--o-----M--?E-------?-?oM-oB-EMoM--o??-E--B-o-?o?-E?BMoME--MB-?---o?E-E??--M---EBMM----
o-o?B-E?-Bo-BB----M?ooM--?BEMBBM-B--B-MB--EB-oM-MB---?----?-M----o----?oo?MMo??-MM?MBB-E??---E-Bo-MBB-M-oB-EM-M?o--M-MBM----oM--MBB-MBM---E-BoM--M-B--B-----ooE-BM--?B?B---o-?---------B?-oB?---B-o-MoBo
-B?-M?-M---BBE-?-oM-Boo-M-BMo-B--BM-?-?------o---M-?M-BMo-Mo?---ooM-E-MB-o?--M---o-?ME-BBB-M--Mo--oM-?B?---M--EBo?-MBBMM?M-o----M-E?o-oo-oB---E--?-----??-M--BBEo??---Boo--??-E-----B--MM--MMo--MM--o-B-
-?B--E-M---o-?-oB--oE--B-BM-oE?oooM--?o-oo------?-B---o----??MB--B??B?----o--E--oo---BB-Bo-o-B-B--o--E-oE----E?-?--MoM-B----?--o-oBE---B--E----?MM----E--E-MoB--EEMME----E----M-??B--MMo--BM?--E?---M?Mv
???B?-B-o-o-??-o-o?--?o?M---?M--M--------BMo--o----oM?-o----?--E-EoM--B--B--oB-Bo??---BM-BE-----BB-oE--B-oEB?Mo------?B-MB----?-?--?M----B?o-oEM--?M--B-E-ME?M-BB-B-?M--MM--?-B-o----------M-EB?---?--Mo
-M--?----BoEooMM---o-----M-BBME-o?-M---?--Mooo--MMBMB---EB--o--BoMo-oBo?o----M--oB-E?-?-ooBoE--EM----M?---MB--?-?-oM---M-o?B--?-E--M?--o--?o-o-oE---B--o?--M??-MM?o--MEB?-o------E-----M--o--?--?oEM?--M
-o-oM?---?EB-B--o---B-B--Mo-?-Mo---BM-E----?-??---B?B-B?M-???---MB-?-BB-o--?o-?-EMoB--M?-M-?M---M--B--?o-BB--?B?M---o-M?--?o-----MM-B--M-------BBB-E---M-o-M--EB-B--BoM--E-BBE--?Bo--oo------M--oM----Bo
-Eoo--ME-oBMoME-o--MM-E--o-----EM?B?-MB--o-oMBBE-o-E?--B?--M??o?BMEB--o-MM-E---EB?o-MMEBMME----M?M-oMM----M?-?-E?E-EM?--B-----BM-E-??EMo--M--E-?MMB-o?-B-B--?o---oM?-o-?---?-B?--oME?oo-B---oo?EM-EBM---
o----o-?-----B-ooo----BBME-EB-??ooM?o--M-?--Bo-?-EE??o-o-T?-?E---E--oE-o--MM-EE-BM--MTMM-EMB-o--o-o?-B--?-BB--MB-M-?-----oooo---??--MB-BEo?E----oBM?T----MMM--?---o---M--?MT-----oB-?-BoB--Mo--M-o-BB---
-oToB--B-?M-MT?M-TE-o-o?oTM-E?M-MoE-oEM--T-E-E--B?T?-T?MT|-------T--ET?-B-T--M-M-o-TE|-B--M-o-E--BTMB?EBM--TE-o-ToB--TT---o??B?ToMB-BM--?--TB------E|o------BMTM-ooE?-MBE--|MBBoo-To-oBT-B--?o---TM?EMM?
m-|BE-o----??|M--|?oEMM-E|-E-ME-oE-EM-M?B|M-E-BMEB|ME|B-||Eo-EooM|--?|-E--|E--?MoEo|M|ME--?--M-B?-|E-oME-o-|--B-|--?M||EBEBooEB|-EB??o?-B?-|o-Eo-M??|M--oM---B|B-----o----B|-oo--E|EM?-|oBBM-MMB-|-o---M
XXXXXXXXXXXXXXXXXXXXXXXXXXXXXXXXXXXXXXXXXXXXXXXXXXXXXXXXXXXXXXXXXXXXXXXXXXXXXXXXXXXXXXXXXXXXXXXXXXXXXXXXXXXXXXXXXXXXXXXXXXXXXXXXXXXXXXXXXXXXXXXXXXXXXXXXXXXXXXXXXXXXXXXXXXXXXXXXXXXXXXXXXXXXXXXXXXXXXXXX
