M?M---oE?B-oo--M??---M-E?--BoM--MBoEMBo-BEMo-BE?M-Mo----B-o-B--o?BMM--E?o---?M-B---o-----EMo--MM------MEMEo-M?M---MMMoBM-M--M--M-?--B-o?B-M--?B-------oM-M----M-?-?------o---BBME-E-E----M-M-E--BMB---oo
-Eo-?MMB-B--o-------B-E?---E---?-?-BMBE--M-BMo?o----ME?M-?---o-----??--BB---B--M??--o?oEBBM--oooMM-BM?BBM-?-?--o?oM?MoM---Mo-o-E?--Bo--?----?------BE-?o-o-E---M----MM--B-M-M--?MM?--ME----M--M-MoooB-oo
B-??E??--EM-oMM?-o?MMo-oB--?E-oo-ME---B----?-B-M-M-oMM----MM-----?M-oo?----M?Mo--???o--MM-B---oB-B---Mo--??B-----MB---EB--M-BM?MBE-oo----B-?EMoB--o??M--E---oM?B-MB--B------M-M----MM-B---BB?B-??B--E-oo
-?--BMBB-M?o-BBM-MB-M?M---?M-?-MBM-B?--ooo--o-o--B?-----o-?------?-E-?----EE---BoB-??E--o-o--M------M?E-BMBM---o-?-ooM-BE--M--Eo-B-B--M-?-BMBo--??Bo--o?B-o-EE?---------oM-Eo-E-BEoMMB-?-o-Mo-M---Eo--oo
----?oM?-o-----B---Eo?Bo----M---?-?E-o-M-o--B?--M-?-o?--o----M-?-o?-?-o-o-BME-EM--M-E-M-?-?-MBB-?M--E-ME----B--B----oE--MoEB?-M-?o-M--B--B?BoBM--o--oM--M----??M-oBo-ooo??o--?--BMB-B-BB--E-Mo---?----oo
---B-?EM--BM--B--B?--?------?-BoB-EB-o---M-B-M--??MM---?o-BBB---?M---o---M--?o?-??--?--B??--B-?B-E---B??oB----?-B----BM-??B---Eo--MB--M--?-MB-o----o?EM-M--EB-?M?--??-M-ME?EEE?Mo-M?BoM--MM-o-MoB---E-oo
o-M--M?oo-o-M--M-BBM-M---E---?o-?oB-B?----BoB--o-M---oMo?-B-?-EM-?----MBB-??-?-?--E?BM--M-?---B-?BB----o-o--?o--Mo-B--?-MMo-EM?-M----?EB--E--o--?----MoM-E-M-B--M-EM-o-oM?--?M-oo-B-o?--M-----B-oMB-M-oo
--?--BB-BE-EB-------BE-M-??--?MM?---o-o-----E-o--?MoB?o-?o---MMM-E-?--o---M--MBB-?BM-M--?BM---?MM-o?M?----?-ooBM-M--?-?-ME--B?---BBBBE?--B?M---EE----EBE--Eo--?-MMB-o--EB---?-E---B-M----oo-MB?-EE-oMvoo
B-E----BB------BEo-?MMM---BoM--oo-----EE?---M-------o?---B?--EB-o-B-?BM-M----B-oEo-MB-E--M-BE-o-oo?---MMM-?B---Bo-o--Mo?o?EM-?B---B?E-----o-?---MMBE-MBM-o?----o?-------B-?-ooB--?-M--M-oM-E-E--M--MMfoo
--M--?E?B?-ME-?-?--oo-?------E-ME-B-----??-B-EooE---oM--EE--MB---o-?--?oBo-M-MM--oo-oM---B-?-?--?-MoB--oM-B--MEME-Mo--o--?MMo-?-ME-?B?o-M-?-o-???-MMEE-o--?M-E-M-B--MoE?--B--M--MoM-BM--B-o-B?--o-oo-foo
--?M--BBM--B?M?-?M--?B-?-?---M--B-B-B-?B---oM?-MMB-?---B?----M-oM?B??B---EB-MM----E--M-M--?-E??oo?BB-?-E?-o?--BEB??---MM--o-------B---?-M--E--------BM-Mo-MB---o----Eo-E-Eo-o----?M-oE--B---?--M--oB-foo
--o?o--B---?E-M-B----BE-o?-M-B--?Mo-o-EB-M--B---EoEEMB?B?-?-?--ME?ooB-o-o?-o-EB??-------B-MBM?-?BM----?B--M--BBBM---M-?o-B-E--B---?M--oB--BB-M-oMM-o----M-o-E--B?M-B?-MB-M------o--o-?o-----EB----o-Mfoo
-----Bo-B--?MB?-E-B?-BM--M----oo---??--?o--?--B-MM--Mo-ooo-MM?--B--M-oE?-----M-B?o--M--o--oB-M--?o-?--?-oE--?-?---T-oB?-o--M-MB--T-?M--?--B--??-B-EoEo--B?B-B-----?-o---M----oM--o--BEM-M----oM?oEE-ofoo
M--E?---T--ME--T-?--M-BEEBBo-----B-ToT?MB--M-o?TE-ETTTEo-o-T-B-M?BME-BTT---T-M---To---B--?EEoBETBo-BMEo-?T?-?-E-BE|oo-o-o-TE-B---|E--??---T??-M?EM?E--ooT---?---?o-??Moo-oTM-o?-E--M-TTEM-o?T-o----TMfoo
m--M-E--|Eo??EB|-----ooBM?o---oMMM?|-|--EEE---E|?-M|||?Eo??|?--o-M-MM-||--B|---??|?EME?-?--?B?B|??-MB-BM-|-?-?-ME-|o?o--??|--Booo|??--?oEo|oBMB---B-?--E|?-BEMEEMMBBBBE-M-|-B--MBE-MB||BoB--|---E?-|-foo
XXXXXXXXXXXXXXXXXXXXXXXXXXXXXXXXXXXXXXXXXXXXXXXXXXXXXXXXXXXXXXXXXXXXXXXXXXXXXXXXXXXXXXXXXXXXXXXXXXXXXXXXXXXXXXXXXXXXXXXXXXXXXXXXXXXXXXXXXXXXXXXXXXXXXXXXXXXXXXXXXXXXXXXXXXXXXXXXXXXXXXXXXXXXXXXXXXXXXfXX
