--B----o-o----M-o-o--MM-o--M-?-B-M-?----B---?--?MoBBEM-BB?BM-BM-E-B---?-?-oEB--MoM---M-EoE-?M-?E---E---BBBB?--oM?o-o??o?--?--B-?--MoBo--?--oEM-BBoooB-B-MB---MM-o-M-o--?B--B?B-E--o-oM?---oE-B--??EEB-oo
---------B-M-o--M-?--B-M-?MB-M--EMoo--E-----?--MB--?---EM--oooMo-o-E-?--BoB----BBMMM-??MEM-B--MB---M--?o-B-MMBM--M----MoMM?o--M-----M-BM-B-BBM--M-?Mo-M-?M--M?-?-o-B-----Mo--M?M---??-?-EMEB-M-----M--oo
-MoM?-Mo--M-oBB--E-ME---B-?BM-Bo-M---B?--E-Bo-BoM-?---B-E-B----?-?----?----B-B?--??-M-?B---BMo?--o?----M-E--?o---Mo--o--?--?oE-EEoEoM--o-?E-?o--M-M-MMo-?-o-----MB----B--E-M-B-MBME-oo--?MBBMMEM-?-o--oo
E?BMo---E--B-?B-----MoM?MMBM---oBMB-----??M--B---?-----M-ME-?-BE-MM-M---E?---MM-B-MEMo-MB--o-?-Mo-----oMM--EE--M-o???--E-M-o-?---M-BBM-ooB-E-?E?o?B-B---B--?-M?-EBMBE-?ooM---Mo-oE?--??-Eo??--B-B--oo-oo
B--o-BoM---?--BBoM-MoM-M----MB-?oBEoE-?-BM----B--o-B?Eo?M--BB-M--?-MMo--?-BBE-B-?oB-BM--Bo?oE------?--?-?oE??M-BoM-E---B---M?--?oM?-----M---EBM-M?BM?E-B--M--MM-?-E-B-B--B-M--E-M-?EMEB-?oE-?E--B?M?--oo
-M-B--MB-M-----o-o--MEo-E-??B?B?--?oM-E-E-M-B----MM---BoM----M--E--?Mo-?o---M?E---BMM?E--o-oM--?---?BoM-----M-MB--?--o--Moo-M--BM-?--EE---E??-oo?EooB?Mo-o-oBMoE--B--?E-ooM?-?---?oB??o-M-?-o?o-B-?---oo
BoEo-EM-BM-?E?-M-MoB-B-?-BE--BE-oB--?o-B-?o-----o-oB---M--M?EE?---o-B--o-E--?oM?o-?----??--o-----?oo---BoE--?--oE-Mo---Bo--?--o?-MBM-M------MB??-BB-M-----oB-Bo--BME-------oB?-E-EE-M----ooM?MMBM---?-oo
-?---?-?---?-B-E-?E---?--M--Eo--M-E-?--M-B--oE--o--M---o?---?-?MoEMoMM------o-?-o-?Bo-?o----B--E--?M---M-----B-o--o---B-oBM-??BM------M--?M-?---BoooMMBBoMEo----o---EB-E---o-?-B--B?---o-B-M-?BB--E--voo
o-----B??---B?---E??oBo-?M-o?----B------M-?----M-?-?------MoMBoo-MB?o--MM--Bo---M----M----?--oo?-EM-?-E-?----BB-------o---BM-Eo?M-??oooB-M-o--??M?-M---oM-??E--E?o-?-oo-o-o-?-MM-?o-?oB------oB---?--foo
-?--oBo-B-oMMooo---?-M-oBE-E?EBMoB-M-?-----MoooB?EBMo--?o--?-o---?M-o--B-EM?--oBMB-B?oo-MoE-M-M--M---o-M-M---Mo--B--EB?-B-ME-Mo-M-oBoBo-E-EBM---B--E?--??---MB-?---MB---o-----?o---M---M??oM---B-?---foo
--E-?-?E-?-E----E----B-?M?-?B--B?-------M-----M-???-?-??-?E--MEMooE-oB-?-B--o---?o--o-o------o----M-?oB-Bo--??oo-M-oM-M----BB?EBo-?o-B--BM?-EM-M?--?-?E-M-ME-M-BB----?o-----M------E-M-??-MB?-B------foo
oB----o?MM--oB-?--Mo-M-?B--M-?-M-o--M----B?E--M?-BB--M?-?o-o?-B--oB------MB?-E?-MM----o---M---oM--EBE-?--oo--MM-B-M-E-BE----oMBBEME-o-Mo-MB-BMM--o?Mo--MoB-?-?----oB-o-E?oo-Mo-?-M?B--B-M--M-B?---E-ofoo
E-----oB?-------BoMMB-o?--B-BB-BM-oMMMB-?-?BEooo-B-----??---T?--M-ME?oE-E-?EE---B--o-o--oB-o-M-oo?B-M--MTo-?o-E-o--oM-??o------o--?--?--M-o??-M-BM-BB---BM?--E--o--o-???o?M-BM--Boo?-BoB-------??-?-Efoo
--M-Mo-oB-?--?-?E?TT--BMo---B-o-?----oM?BMMB-ME---ooo--??BMM|-T-Bo?M--M?M-M?TM-BMM-TT-?T--Mo-T-TTTE-o---|?-ToMB-EE?-B-----oBT-MB--M--oT--MM-??-E-E-MBET-BM?E-B-TEo-o-oEM-TB--MB---?MB-?T-o-B-TBo--?--foo
m?-E-ME?o-MM--E-BE||-??-??-ME-B---ooo-o?---MM-MB-M-M?-MEME-E|-|-MM--E---M?B-|MoM?-?||?M|-MB-?|?|||B?--Bo|EE|-E-o?BM-B-EB--B?|-B----B-o|--M--?-MM-B-EMB|?M---BB?|M---oM-ME|o--o-EM---E-o|Boo-o|-MooBMEfoo
XXXXXXXXXXXXXXXXXXXXXXXXXXXXXXXXXXXXXXXXXXXXXXXXXXXXXXXXXXXXXXXXXXXXXXXXXXXXXXXXXXXXXXXXXXXXXXXXXXXXXXXXXXXXXXXXXXXXXXXXXXXXXXXXXXXXXXXXXXXXXXXXXXXXXXXXXXXXXXXXXXXXXXXXXXXXXXXXXXXXXXXXXXXXXXXXXXXXXfXX
