-o-M-?o-B-?-Mo-----o-?o-MB?-B-?-oMMoEo-M?MBoBE-?-----E-B---oB--B---EoM--B---?------M?BB-B-?o-B----Mo--BB-M?B-o--?--oB--?BEEM?--M--B?-ME?E----o?-B-EE--MM-MB-B-M--o-M?---M-??EB-?-?MBoM?-?---MEo?M-----oo
--B?M-B--o?BM-----o---M-M?-MBB?-M--o-Mo---?--B-----M-?-?o---B?o----?-?-?BB-BB?M------M?M-EEB-B-?--oo--B-BMBBM?EEM---B?E?BBB-ooo?--M-B-MMMoM-BEE---?M-o---B-MEEM-?M?MBE--M-------?--M--M----M------???-oo
-E---M-EM?---B?-o-M---oEE-E-?-B?--------EM--o--o-?M--?--B---?-?--E---oE-?-M?--Bo?-?E-B-M-MBo---EMMB--B-o------??BB---M?o-o-E?--ooM-o---o-BM--B?----o-MoM?M-oB-----M?-?E---Mo-B-Bo-M------Bo--B-Mo-oMo-oo
--BEM?-MMBBMM-Eo-M-?-o-BME-MM-?--M--BBBBM--EM--BB---M-E?B?ME---ME--B-B?--B-----?E--?---o--??--?-oo-B-----E-oooE?B-o-o-E?-B--?E--B-o-o-EM?Bo?M-oB-ooM?B--B----oBB-M-B?B?---MBMBE-??MBM?B--ooM-B-B---oo-oo
B-?-------B?-o-B-Mo-M-B?oBo-oEEBo?-oM----M?M-Bo-o--oB-M--oo?oo----EEo--?Mo?ooo?M?--oMMB-??o?--M-oBBEM?M--?EBM-MMooE---B-oo-?B-o--B--oMBo-M-M-E-o---?-?----Boo-----o-E--Eo-o-?---EBo-E?-MMoBM-?--Eo--o-oo
oE-M?--B-E--M-?-M-E?--BEo----M------B-oEE-BB--oo??--M??M--Eo-o-o---M--MM-?MMoM----E-M?o-BE-M----E-EBEB-B-MME--?-E-M---MM--M-MMMM-----?-E???MoM-----------E?--?o-?---M-B-EEoo---M-o?oBM-B?Mo-o-o?BMBEB-oo
-BM-ooE?-?------??-o----?-M---B-----------MB?-B??--E--oB?----B--?-----M-BEM--E-ME-M?B?--B-??----BEBoBoo-o?----?BMoo--?--?oMEM---M--EEB-M---E--o--ME--M---?-o-MM-o?o-o?-oMB-MMM-?-BM?Mo--EB-o?-o-o?M---oo
M--?-B?-?--?------oM?--o?oBBo--oB-o--E-?-BE---B-----Booo---?-o-o---MEBB--M------M-?-MM-Mooo-B---BBME--o-o---ooMM---E-o---BM--B------M-EM---BE-EM-o-oo-M-BM-E-M------?-BE-BEMM--E-BEB---oBo-Eo--B-Mo?Evoo
oM-Boo--?--M---?B?---?EoM?B-M-B-?-M-?B?o?E?M-o-o-oM--E-Eo?BB--BB--?E-?-M--oM?M-oE-ME-B-o---MoB-?-oEM----E---M-ooE-MM----?--BM??-----M--ME---Bo-o-?oMB?BE--MB?-B--MM?-o-B--M--M-MEoB---B-B-B?-MM-M--?Mfoo
--B--?Bo-?-M----B---?M--B-E?--BBo-oEE?-E-BM-M?-----M---B-----o?---?MBEo---ME---o??-B-Bo-?-?-o?--MEB-MM-oBo-M--B-?-MB-oo--o----M??-o?--Mo-EB--MBE---B--?--?M----?Bo----Bo-EM-MoM-?o--M-MoE--E---E---E-foo
--BoE----o-?-M--E?--B-EoE?--B?-Bo----MB?-?-??-o---o---BEEMo?Bo--?Bo-E-o---BBo---B-----M--Mo--o--M--o--MB-B-B--oEM?--?-?M---B-o--o??-?--oE--M---M---??-M-M--BBo?-MM------MM-o---oBB-o-EMo-?M?M-?---o-Efoo
-MB-?-B?B--MM?E-B-oBBEB-M--EB-EB-?-B-o--oB---o----B----?BM--B----o-MM--ME-Bo---E-?o-BMEBoMo-o-------o-Bo?o-o-oM-Bo-oooB-MoEo??-??--o?---M?E---E-o--MM?E?-M--oM?-----B-ooM-?E-ME------?---M----o--o-M-foo
-MoEMoE--?MM-B?oE-oMo?----E---M?-----?o??---Eo--o--M--EBoB?-B-MBBM-M-?BBB-----B-M?--M-B---TM------o-o-M-B-oE-?-BoMB---MoM-?BBTT---M-BMMo-EB??E??M---o--EEBo?-M-o-o-ET-o-B?-T?B-MEB-MM?----T-M-oM-?--ofoo
ooM-T-BTET?--B-o---ooBM---?---BT-o--Boo-E--MM?o-T?--MMM?--T-?---ooB--o-T--M-E??-----M-B-BM|TBTM-E-o---?o-TT---o-ME--BT-T---?-||-M--M?-B-MBT-E-oBT---Mo-T--MBB-MB--o-|M--B--|oBE-ToT-?--o--|T?-TB-B-oBfoo
m-??|-o|B|oBBB---M?EoMEM?---BEB|M-??MoM--E-----E|-o-B--BM-|-E----?--B?E|o-MoBB--oMM?o-E-BM||o|-E--?EM----||-?o---BooM|M|EEoM-||M-M--?B-Bo-|MB--o|?-?E?M|?oM-MBoM--B-|?E----|BE--|?|M?MEM-E||-E|???B-?foo
XXXXXXXXXXXXXXXXXXXXXXXXXXXXXXXXXXXXXXXXXXXXXXXXXXXXXXXXXXXXXXXXXXXXXXXXXXXXXXXXXXXXXXXXXXXXXXXXXXXXXXXXXXXXXXXXXXXXXXXXXXXXXXXXXXXXXXXXXXXXXXXXXXXXXXXXXXXXXXXXXXXXXXXXXXXXXXXXXXXXXXXXXXXXXXXXXXXXXfXX
