Mo-M--o-o-?-M---Eo----BMMB-B-o-M--o-BBo-------B-o-MM--B-E-?-o?B-o?--?o-BEB-?-M-MM?--o??-oo?B?oB---BM-EE-E--o-??E?o-?M?-M--M---?-B?o--o--MEB-EME-E--M-------o?---oM-----E----ooM?---?EE--M---Bo-?o-----oo
-o--?-?B?MBo-o--?--MMo?--oE-E--EoB-M?-MMEMM-B--Eo-EB-?-?MM?-M--BBB-oBEEE--B-M--?B?EM-B-oE---MM-?---B---MM--EoMoB--M--------o-M?----M-Bo--B--?EB----?E?--Eo-?B-?MooB---o---oMM-?o-EMo-M-?Bo-?-Eoo----o-oo
M--o-E--M--o-oEMo----o-?-BMMB-??E--ooM-M-EM----BM-BBMB-?B-M-M-oB---Eo--Bo-o-M---???-----?----?M---E---BE---M-----oB--B-E?------B-B-?---??----BE--oB-B--MM------B-----E------?-?B-MoMo-M??BE--BBoM?B?--oo
--EMEM-??--?M--B---M--?-?-B----?---oo--M?M?-?E----oBE-----B-oo--MM-B-?o-----M----M------?----Moo-E?o?B-?M-EM-?-B-o-EE-MM?--oM--?Bo--M-----E-???o-B?MB-o-?-BE----E-BMB-BoEME-EM--o--M-----------M--E-B-oo
-BB-??-oM-----oEEM?M----Mo-B-B--E--?oo?-B--BoB--?Moo--o-?M---MB-M-B-?-Moo---?----o--o-M---oM-?----M?Bo-EB---Boo-?-B-BEooM----ME-MoM-?B------M--E--?-B-E-B--B?M-MB--?o-?-M---?--o-?E--oB--B?-----B--o?-oo
B--B?o-----B?--?-M--B?-----oM-o-?----BE?-MoMo?-BBM-E?MBB--o-M-M----BBMEoB--E--?o?--M--E-ME?-oo--MBMB-MBMoMo-----M-o---oBM?--M---oo-o?M??--------M--M-EB---Eoo--B-?Bo-B---EoE--B?--B----E?---M--BE?--B-oo
ooM------B-?------------o--EB-o?-EBo?-MB---?BMB-MEB?---EEBMM?-??ooM----o--?-o-?-M?EMEM-MB-B--?-?MBoB-MM-o--M-E--E-?-BoE----?B--B-o---?----MBBME?M-??M-E--o?B---?-M--MoB-BB-?-BB---?o-BBB----oM-?-oo---oo
??EMB-o-M-BE-?-M-----BM--BM-?B---M-?---MM--B?--o--B--?E-?----BMB-?M---o--MooB-oo-B?oM----Bo?-B-----?-----oooMME-M---?-BoM--M?-E--MM-----M?-oM?M-M-BBBMMo-o----o?------?M--BE---?-EB-o--EBB---EB---o-ovoo
o--oBo-M-?MBE-----?-B??-BB?o?---?---oo-----E--ooo--oM?-?M-??--Moo----BMM-EMo-?ME-o?B-oM-o-?--ME--MoM-----Eo-M-?-Mo---o---MBE-o-?o---?-o-MB-BB?-E-oM--?B?B-----?-E---o?-Moo---o?----oo--M??B-EB-o---B-foo
-M-B--o?oBMB--ooB-M--B-M--BEB-----oM---o-?MMooBo-o--?E----B-o---MBBEMo-o-------M---o--E---o-B-B-M?--?ME--?BE-M----E-?-EBEEB-o-?oB-?-----o-M---M?--E--E??--B-BBMM--?Boo--B--E-M--oo---B---MooB------o-foo
?---?M---E----BE----E?-B?---BE----M-M-E?MB???-?----oMB-----?EBBMM--M---?-MM-o---E--------o--oBM------B?-MB?MBo--EMM-MoM-?--M???---Bo--B-??oM---E---?---B------o-B----M-?o--MB-?E-o?o--E---oBBM?B-BBMofoo
----BE--?--------?EBM--M?-BE--EM-B-o--?-o-Bo-M-M-Bo-o--B??-M?-M-??B?BM-?o?o--?-o?M?----B-EM---B---Bo----o-o--?MB-?--B----o-MM---o?o-o-?-E----oB---B-o?EB-B-oE-M?MBE-BM-MB-o---B-o-o--E?o--B?o?BMM--E-foo
-o-o-M?-M-o-EoT--E?-o-oMo?--o-MM--M-E-B-B?-M-oBBE-M-EB---B-?--oT?-o-?MB--E-B-Mo-?M--?---B-BE--M---B--E-ME?--MBM-?-?----E-----B---?-o-?-BBoMEE-M--?-?o?--?B?o-?B?---?-o--B-o-B---B-BM-MBEM-M-E---o--B-foo
BMM--MB--M--Mo|---?-TTEB-o-BE-BEBT--TT-EM---BTTBBM---?M?T--EE?M|-?B--MM-B-oE-B?EM-?-M-?--oB-------T-BM---ETT-B-EM-B---MB?-ooT-E??B-B-M-o--??BE?o-B-o-?-T??M?-T??--o?B-Mo-E--T----M-T-T---M--MMM--?B--foo
m--MEMMM--E--B|oM-?B||?-B?E---oMM|--||-?-----||oo-----?E|ME??Eo|EMM-?o---M-M??EMoMBo?ME--?-o---MoB|BBE-oB-||-EM-MoEB?MM--BMM|-MEBoMo--oB-?oBE-M---B-BEo|?--oo|MoEM?MBo?-BMoM|-o---E|-|BM-?B--o--Mo-E-foo
XXXXXXXXXXXXXXXXXXXXXXXXXXXXXXXXXXXXXXXXXXXXXXXXXXXXXXXXXXXXXXXXXXXXXXXXXXXXXXXXXXXXXXXXXXXXXXXXXXXXXXXXXXXXXXXXXXXXXXXXXXXXXXXXXXXXXXXXXXXXXXXXXXXXXXXXXXXXXXXXXXXXXXXXXXXXXXXXXXXXXXXXXXXXXXXXXXXXXfXX
