MB???---?-oE--M---?-Boo---?MMB?MM-Eo-----o-M??M--BE---EBoo---?M?MBE-oME?-----BB--MMMBB--B-B-?--?-Bo-oM-M------oM-oB?-?MB?oo??M--B-?E?EMM-M------?---M--MBM-M-?-?o-M-?E-MMBoBMo--MMBM?-oMM?--??M-------oo
B--?o?-o--BB------?M--?BMoM?B---M-?o-?----M-?-----?---B???---?-o-M-o---o-?-M-------?E--??-M-B--o--?-E--M-B-o----oB--oM--o-MM?--o-?-ME--B-M-B?o??--M-BE--M-E--?E-B-?B-M---?oo-E-M-B-?-E-o?M--M--E-o-E--oo
--o------o--ME-EB--?Mo--oM-o??--BMBo-?--M?E--MM?---oM-E---M?M--o?-EoME?-MEo--E--B-o----E-oM-------o-?----M-M------M--?BEo?B----M-o-B??E--B---Eo--oBoEB-EB----MB?EEo--?-B--?--?--o----MMo-?E--B---MBM--oo
E-BEM-EE--?--ME---B-o---EB---?Eo?--M----o-?-E-B-E-M-B-B-B?-----oo-BBoBB-M--o----MM------oo-?M--B-M-?--?---o-Boo-BME--E--?oBB?M-B---B-?M------B----Mo--BM?MMBBB---M---?M?---------?oooE?--M----o--o?---oo
?-?--EMB-Mo---?M-M---B----?---M---M---BE--M---o?B-MoM-?MM-E-oBo--B-o---B-o--?--?o-o--MM--B--?----B?--?--M-oBoEMoMoMo-B---??-BE--EE---?-B?BB-MEo---o--------o--o-BM-?-oB--BBo?-?--?-o?B?---o---?E-MM---oo
-E--M?-E-MMoE--?-oB-B---o-MB-o-oo-ME-o--E-MBM-?M----o-o--oM--?-E-M??-M?M?BBE---oBo--M--M?B-M---BBB---M--B-?B-?o---------ooB---EoM---?o-M-?-E?B--o---?-o-M---EB----o-----?E-oBo--M---MM-Mo-?M-M-?---?--oo
-B-oMEB?-M?----EM-M---M----B--Mo-oBB-E-oM-??-o-Mo--M--B--oM?E--?-?-EMB--?B-??----?---E--o-E---oBM--?MoMoB--?M?--MBB?o-o--?--o?MBM---------BM--E-?BME--ME?Eo-?B-E---?E-E?BBME--M-------B-E-o-------?Mo-oo
------MEE--oMM-M--M---BBB-o-?-----BE---B---o-M-?-M---E--o-?MB-M--BM--B-EE-Eo--?-B?M-MBoE-?BB?--B?----o--?--oB?--B---?-E--?-------o?-----o-?-?-MBE?BMM?EM--?M?-MB------BoB?--EEoo---M---o---o?M----BMMvoo
EB--M----M--MB----BEEo?BE-o---o--------M-M-?o---o--B----?--ooE---oooB--M-o-o-?-MMB-MEBoMM-?-???---o-?-??-----o-?o-ooM-?--Mo-Mo-Bo-o-BMMMEB--?E-oB-MB-?Mo-M-?B-M?-oB------M?-------o------?--?MM----B-foo
M-?-M--o-EoMBoM--B--M----B?BE--E-?M----M-M?o--B---Moo-B--B--MMB-o----ooo-Eo--o---o-B-oo-?-E---o-?-E?M--?----?--?MB?B?-BM-o-oM-?o-E--MBE?-??EB?B-o--MME--BB?E---M-oE--?-BB?o?-B-E--?o-M-M---ME-??oM-B-foo
Mo---E--MBoo---E--o-?M--B-Bo?--B-o?E-B--M?--Eo-E--?---Bo--o---EMM-M??-?-o-?--MoE-E---?-o--MEooBBB-Mo-oo--MBo------?-?-M-M-E?-oo--M-?M----EE-o---Moo?--M---B??MM?o?-?-M-E-B-E----M-?-?--B??MB---M-MB--foo
-------Mo-oMo-oB--B---Boo-?-BM?M?--?oo-??o??Moo-M---B-?-B----o?M--?Eo-?-BoM-?----MM-MBo-?MM---?--?-???B----M---MMMMB---o--M--Bo??--oM-E-E----?---------M?-o-o?B-B-o?-oo?MB?Mo-M-o--?BMo-?-oE-?-M--M?ofoo
--oBB?-M?oo---BE----oB?-B-?-B-o-T--E---Moo----B--EM---B-o?--o?-MB-MM-----?E-ME?------???Bo-MoM?E-BB-Mo?-o-o--B--MM--EBM?oBBo-B?BMMo-E--E-M-----?-?o-oEM-?---E?-o-------o-E---EM---B-o-BEEEo--BoB---?-foo
-E--?--T?---?TT-E--?To??-TT?--?B|M?T-B-?TT?T--M--T--T-oM-TT-oB?-MB-T?-ooME-o?Bo---TMM-oTM-oE--EMTE??-E-EoBM--Eo---TM-?T-oMBM--o--BMEBB-BBB--o--BT-?E-?TT?---BMoM?----BoM-?E?--?M---E-Mo--T---M?---B?Bfoo
m??-Eo-|----o||-?EM?|M---||-ooMM|M-|oMM-||-|BE--E|-E|BM-B||oo?o?-oE|--MEBB-EEEME-E|---E|BB-M-B?M|M--o---E-EoE?MoBB|-B?|----M-Mo?oEoMoE---?oMMB--|?o-oM||-B---Mo-B-MEB-ME-o--M-?--Bo---E?M|o-o--MB?M-Bfoo
XXXXXXXXXXXXXXXXXXXXXXXXXXXXXXXXXXXXXXXXXXXXXXXXXXXXXXXXXXXXXXXXXXXXXXXXXXXXXXXXXXXXXXXXXXXXXXXXXXXXXXXXXXXXXXXXXXXXXXXXXXXXXXXXXXXXXXXXXXXXXXXXXXXXXXXXXXXXXXXXXXXXXXXXXXXXXXXXXXXXXXXXXXXXXXXXXXXXXfXX
