--B--oooM?--BBoM-oo--o--B----M?M-?MoMo-o--????o---?MM-MMM?Mo--oMB--M??M-M--B?oM-E?M?--oEM?--B?-MEE--??-oM?BM--o----B?-?-?--Boooo-ooE-E---?-?-Mooo-B?B??B-------?-o--?o--Eooo--?oE-o?BoM------o--o-E??-oo
o-?--M--Mo-B--B?--BB-?-?E---o--Eo??E?B?o-E--BE-?-Mo?M-???B?--?EB--??-oM-BB-B-Eo?-?B----Moo--oBB?--o--o--?B--o?EM----?--?-?-?-?E-o-?-??BB--oo-B---?-?-E?BM?E-ME-B--o?o-B--?-M-???-o-B--oBoE-MEo-o-B-o?-oo
B-?M??oo-B??--?E-B?-EBE-o-EM--B?-o?-o-??oB-?M-?--o-?--o?--o---Mo??-??--?o--o-M---BB-?ooBE--o---E-BBBoE-E--M--o--???---oMM---oBM--BEMMMo-?E-BoB-M??-Bo-Mo-B--BM-o-o?-?oBB-M--o-Bo-oo--?M?----MMEBM--?--oo
---?--M--M?Bo?B-EE?BB?--E??-EBoE-oo-B----MooMo?MEooo-oooE-BB--?oooB---o--?E-EM---?-B-?--Mooo------o??-B--ME??M?-MB----??-??oo?ooEB-oooo-o--?B-Bo-o-oMMoB-Eo--oo?M--?oB-BB-oo?-o?-?BBEB-oMEM--o-o----o-oo
??ooBBM--o--o??-M-?E-?-?BMo???-?-oMooo-?E--B?--oM--B?-o-B??----o?oB-o-o?-oM?-Bo-M??Bo-o-M-E?-o-BBBM-E-oM-----M-?ME-Mo-M---MB?M-EB-oM?oM----BM---ooMEMo-o-B-?E-o--EBEB---B--E---ooooo--??M?-B-?--?o-oo-oo
--?oM----Mo---?---??oBo-oBoBoM-B-o-oo-?--o-?oMB-??-ooo----MB-o-BM-BB-o?ooMBBB?-E???M-o-?M-??-Bo-?M-?----o--BM-?--BoMMEB?-B--oB-B?B-oBoMo----oM-??oM--ME?-B?BB???B--B--?o-oM-B---M-?M-E?oo-M-?---EE--?-oo
-?MB-o-?B-Mo?-MBMBo-?--?o-ooMo--Mo-E--oo----M-MoMoB??BMo-?-M--Mo-?-oM--o?-ooMo---?-oMM?B-?o--?-MBM-oM--o-?---oooB-M?-ooE--o---B?--?M----E-?-oo---MB--MMo--o-?-M?E-oo-?B---Mo-------MM--M-BM?-M?--B-MM-oo
-?--?-BM-Bo?B----??--M??o-oB-BMo--o--M?BE-?-M---Mo??ME--oM-EB-?oB?--M-o?--?--BMB?o--B?oB-E??oo-B-ooM?-E-Mo?B--o-?M?-?o--??oooB--M---BM-??MM----oo?o-B-MM-E--M-------o-BB?B?Eo?-o-E-E-----M--B?o--o-B-voo
o-Mo--E--MMEo-oB-?o?-?-o?-EB--o-?--Eo---BMo-oE?-MMEooMo??-E?-?-??M-oM--?BB---BoooMo?-BB---EM--o-o-o-M??B--Eo?--?--??-oM-??--BBBE----??Bo-?ooB-MB--oo??--MM??-?----o-?---oM-?o----BM?-MoBo??o-?---E-BBfoo
?o-M-M-EoB-M---?BEoB--B?o--MBo--E?M?M-E?E--??---M-Bo-ooM-?-o?MBB-?E-E-?oM-E-EBM?-?oM----Bo??oBBM--ooo-oM--B?o-oMB-M-M----?--ME-?oMBM-?E?BB?--MM-o?M--B?-BM-B--M-Bo?oo---M?---o??M?o-EBBB-MB-Eo-B-M-Mofoo
-E-----M-?B--M-Bo?-?BMo-E-M-M?Mo?oMMM--?M--oE-oB-Bo-B-B-?-B-??-o-EBM-o??o?M-BooM?-o-E-BE?-Moo?-o-o?-Bo-?o-E?--o-E?Booo-B?E---M-B?oEooB--B---o?-?--------M?---oM??B-EE-BM-M?--Bo-o-o-?M---B--??-M?-M-Efoo
o??E-?oM--?-M------BoM-?-M--?B-oBoBBM?--oMB?-M-oM-Mo--MEo?-o-E?----MEMM-E?BB-M--oM?--o--M--oE--o??--BooMo-M-E?---B-?-?-Mo-oB----?-?--E-BE-B---??MM-oBMoM-oBo-B-MMMoM?--M-o?---M-?M?E?oEoo?M--MooE-MEBfoo
oMo--M-MMEo-?-E----?Moo--B-ME-o-o-??-E?EE-oo-?--E---MM??-oMB???-E?-?MoMoMoo-?o-----B---o-?Eoo?oM-B---B--M---o-B-B?MBo----?MM--o-----?M?---B-B---E-oMBMBBBM??--o-MB-o??M-oM-E--B---oM-MBM?-o---M???o--foo
M-----o--M--?M-oo--M-?o--?--o----??o-??-M-E--o--??---MEoMoMB??------o--o--M-E-?B-BB----?-E-M---o-E--B--EB--oM--MB?M??o-------o-----B-?oB?-??E?-oM?Bo--E--B--B-?-?--E-?-oo?BoBE??--?o?oo-?--E--?--M-M-foo
m----------------------------------------------------------------------------------------------------------------------------------------------------------------------------------------------------foo
X----------------------------------------------------------------------------------------------------------------------------------------------------------------------------------------------------fXX
