M-o-----E-------M--MME--MME---E-Mo--M--M--B--??o----?---BB-B---MM?-BME-MMo-E-BoM?BoM?BMBBB---o-o-MM-oBBo-Mo?--E-?---o?o-----BEE-B-----?M??B--B--Mo--?o--------M--MM-B?-Bo--o?--?BMo--oo-----E--BM--o-o-B
--Bo-o?-?-oE-o-o----BB-M-------B?-M---oB--oB-o?B-M-?-----?-B---M-?--?M-?----?-Moo---EE---o---E-B-oM?--oE--o--o?-?Bo-BoM--B----BM-B-M--o-----o-EB-B??---o--M?B-?---B?--Mo-MM?MM-M?-E--BM-----M?B-oEBoE-B-
-B?-M-B--M---M--E-o------?--EB?---BM-o---oEoo-MoEMo--M-M---o-o-MMM--?-B?-MMMB-?EM--?MBooME-M---?EMEoo?-B?--?BEo---M---o--?oB-M-??--------B-?-oB---M-?M-M-E-o---?--BBEoEB--o-?E??--?-M?-?M-M?M------MM-M-
M-E-M-M-?-B-----?-o----B-E?--oBoo-?oBo-B--M?--B-?E-o-?-B----E--o?-B-?-MEM---BoE??--E-B-B-M-?-E?-?MMo---M--oM--B-M-B-E--?M-----Bo---B-?B--M-MB-M--BM-oM-M-M-Eo--B-EMM-B?-?o-EE--o---E---M-Mo?M-E-B-B-E---
E?M---E-MM---------o?o--EM-??----oE-B--o?---E-----B?BoE?B---Mo----?EM--BM---o-?oB-E-?---?BM----o--?-E-?---MM-B-EoEB-B----M--?-?M----MB-oE---M------o--o--o--o-?B-?--E-MBM-E-?--E?B-M?--BB???B---o--EB-Mo
??-E???-?---?----o?-?-E--MB-??BME?MB-------?-BoMM--M---?-M-oBB?o-M-B--o-EEB--oMM-----Eo-o?M-?-M---?o?o-Bo--o--BMM--BBoM-M-----ME?B-BMo--?M--------B?---o?-o-??----E-???-MB-B-oM-o?---oBBEMo---o-oEBB-B-o
--?M?--B-BB-?-Bo-------?-B---oE-?-ooB-o--?oo?oBo?B-?-Mo----B---MB---E?BM?---o?M-?-B----oo---Mo--Mo-o-----??---M--?-B-o?--o---M-M---------B--MM?-----Mo??M-?M----E--B-B-??B-Bo------M?M-o?B----BM?-EE-B--
-EMM---B-BB?--BB-Eo--?-MB-M--M?EEM----------oB--ME--M-o----MoEM??--?--B--B?o-o----ooE-B-----B--o----?-?-----o-ooMM?M---oB-BM----oB-EE-M-----M-o?-ME--------?-ooM------BMMM---o---o---M-M-Eo---?--B-M-??v
-----oBMM?B--B----?-?--BEBBo??--?BB-EM---o-o?MB-M?-oBB-E?--B??o---oM---MB--o----?o-----?-o-E---E--oo-B--B---o?o--Eo---o----M?M-oM--M?------??o-M--B--?BMo---B----E?-?-MoEE---M-E-B-B---M-----?B---M-oo-o
---?MMM--E----Eo-o-MMME-M-M-----B-?-M?o-M-MMM---BoMMo?o?EB-B--M--o-o?BB-Mo?oM-----o-M-E?--M?M-----oM------M--?E-o?-Bo?oo--ME-MEoME--M?--B---oB--E?E?oM----o?B-o--B--?--o---?-?B-o--?Mo----BBo--oE-BoB??B
-B-B--?o--?-BM--EM---B?o---M-?-?M-o-EE?-------o--oEBBM---ooo--------EB?---B?---M-------o-E-B--M-M-BoM--EE?-B--??-?MB-B?oo?-Mo--E-BB-B----M------ME-o?-o--M---BBE-M?-?Mo--B??--E?-M-o--EB-?-?-B-MB-?Mo---
-E--o--?M-B-o?B--------?Eo-B-------M-B-MME-oM--?-oB-B---M--oM?Bo--o-MB---?-------B---M-E-MB--?oB---B-?-M-----B-M-----ooBM??--B-?oB--??MM----oo---?-M---o---BEB-?BEo-E---?----M--?o?---MM---?--E-?--?-E-?
?--oo-B-M-o?-o--o--M-?o---?M--?-oo-----M-?oMM-?M-oo?-oo-EBo-oo?M-MMB--ooM?T-Eo?Bo-M--o-TB?B-----B-?-M-M--E-E--BB-oo-EE-oM-o-Mo?-B--?--E--MM-B-Mo-?BB-E-E-?-B--B?---B??M-??-EoM?B-??B??-o-MM-?o?BoB-E-BM-
-oo--T---E--?T--B----T-BT?-T-oTEM?-o-To--oBo?o?M?E??-T-oBoMM?--o-?E-E-B--T|--TTM-?---Mo|--EB-oTBT-B-E---oT-TE-T?-o-E-TT--?T--BB-M-B?--MEE-EBT-ET?oMEB?TBM-?MME?--??B-M-------MTB--B------o---?--?B-TE-TT
mo-?M|MB-M---|?ME--oM|--|-E|--|--Eo-?|-E?EB?--Bo-B--E|ooo-B-?-ooBEBoMEE-E||B?||E-oEE---|-E?-B-|E|?B--?M-E|B|M-|MB-M?E||B-E|-B-o--oMB-M-M?BB-|-M|M-o--M|oo-E-M-M-E?-oBoEMMEM-oM|?B-E--BB----BM-M--B-|??||
XXXXXXXXXXXXXXXXXXXXXXXXXXXXXXXXXXXXXXXXXXXXXXXXXXXXXXXXXXXXXXXXXXXXXXXXXXXXXXXXXXXXXXXXXXXXXXXXXXXXXXXXXXXXXXXXXXXXXXXXXXXXXXXXXXXXXXXXXXXXXXXXXXXXXXXXXXXXXXXXXXXXXXXXXXXXXXXXXXXXXXXXXXXXXXXXXXXXXXXX
