-B?M-o--MMBMB-o--M-Eo--B---?M-MM-B-oBMMBoB---MMo--oooEE??---B-B-o--o---o-o?-E-Bo?---?-o-MBoo-MM?M-oEo--B----B-M?--M-Bo?M?ME------ooMB-o--?-?--M--BBoB---BB---E?-MMB--oM-oo--E-EMoME---B-?-?o-?M---M??-oo
-M--o--B---MM-----EM?-----MMoM--?------EM-?M-oM-BB----Bo-o?-?-B---?-BEMo-?B-Mo-B-----oooE-----B?---MoMEo---oBEo--?--BMMoM-?ooM??-?-E-----M----M---BMo-o-?---o---B-E-?B---?o-B-?---M----oM-E--?MB-E----oo
EoE?o-----?--M?Eo--??-B-?---?------o?-EM-M--??M-oB?EE--B--E-EM----Bo-MBBM-ooMM-M-B--B-oMM-E-B?-Bo-MEo-BB----BB--B-EoooM?oo-Mo?--?M---Mo-oBBB-o--BB-M---------?M-M-Mo---o--Mo-B--o?Eo--B---B--MMM---o--oo
B--Eo?-E--o------oMM---oM---MB-?--?B--?-----o----Bo--o-----MM-----?---MBBooBo-MoBM-?M-?-M---Eoo?-o-M-?-Eo??MB?BE-oBBoME---o--B-BoE-----oB--?o-M----o--Eo--BMEo--?-B--oBE-BM---B--?MoM-B--?--o?MB--B-o-oo
E?-ME-B--E-B--oMoM---o--oE--M?-oo-?o-M-B?M-----o?--M--o--Bo?o-B-oo----Mo-E---??M-----B-B----BB--Eo---M---M----?MBo--o-BEoE---MBM?---?--EBo-o-?-MBM--MEMo---?M?-o--BBM-----BoBo?--o-o--M-oM--BM-MM?MBB-oo
---o?---oMo--oB-E--E-E-M-ME--MBBBEMM-B-?-ooB?ooB--Mo?BBo-EE-B-BEE---M---o??-MBoEB--o---MB--M-Eo-B---o-----?-B??BMME-M--M?----E-----EB-BM-E?-Mo--B---B-M???-B-Bo?-----?--E-E-----o-EMB---M-o----M-E?M--oo
-EB-----o?B---o-?-oM-BB--?--Mo-----o-BB-B--M-?----M-M---oB---oo-M-E?ME-M-?oo--oM-MBo---EB-?--?M-----??--M?-E-?M---?---?--?-Bo----Bo--B---?----M-o?MBo-B------E?-o--oo-MMB-BBM-M---M?-?--B-??--o-M?M---oo
BB--BB---MM--?-MM?-M-?o?BM-B---B-M-o-----?-?B--BM-----M-EB----BMoMM--M-oEE-E-oo-E---?-?BB--E-M?-o--?--M-?-E-oBE--E-?E--oB--ME--oB?M-M------M---M?-ME---EEo-B-?--M-M--o----?oE-M-BMo??---?o-Bo-BM--EB-voo
B--?-EB?-o?oM-M-B---??---Mo-??---Mo-?-Bo?-E-BEo--?E-Mo-E--Mo?-M-?E--E-B-M-?--E???Bo---BMB---B-oM--o?----?M?BB?--E----oo-M-BMM--E----o-E-M---o-BooMB?----M?-?----BE--oB-Mo-B-Mo--B--oE--B?--B-E-EB-Bo-foo
----?B?---?-M-Mo-M--?--B------?-?EMo-o--?-?--B--B-BE--MB--B--M---MME?-M---M--Boo---?MM---Bo-EB-?E----oE--Mo-M-MM-oB--ooMB--BMB----EB?E?----M?---B-B--o-Moo-?Eo-E---?Eo-B?---?BME--M-BoB-?--MB--?-M?-Efoo
-----?-M--BM-----Bo--------oMM??----M-B?M-BoB?-?-M--o-Mo-B---M-M-ooM---------B--MoE-B--oo?-MME?---o-MM--E-o-----?Mo-?MB??-----E-M?-?o?-??o-oB---EEE------Boo?-EM?-?M--M-?B-M-----E-Mo-B-?--B-?-MB---?foo
-B?--B-BE--?BE--oB-----BM----?---?--B??M-??E--oB-EB-E---?EB----M-E-?-----B---?o?E?Bo?-?----o?--BBo--o-B----oB-oM-M--oM-M----?MM--B--B-M----E--E??-BBMo-?----M?-B---BB-oMo-oo-?oB---M?-?E?-EM-MBMM?--Mfoo
-M---o?o-Eo--M----BT-Moo-M?ToM?-M?-EM--BM-?--?-Mo-?TM---M-?-oE?o-MM---?-MM---o--?---MM-o?-B-E--?---?--?T---E?o??--M-?-M-MB--?EoMET-Mo?---MEMo-?B?B---?--B-M-----?EM-?-EBMo-?-M-?oE-B--MM-o-?E--M---Mofoo
-M?----o--?o?--ooB-|-?MTBB-|oM?o-oMM--?T-?B-?Moo--M|oM--oM-E--BE--?-MM--o-M-o-o?TT---Bo---TMMoE-o-o?-MT|M--T--?BE-BTBo--BM-?-B-MB|-oM---E-MM----------B-TEo----BB-o---ToT-To---oo?EMMooo-M??MMEB-----foo
m-?-ME-?B?-ooE----B|Mo-|B--|??M?--MM?oo|BEE?E--o?--|-o-?B-MBMoM?-EoMoBBoE?ME--Mo||E-E-B--E|B----E--B?B||---|E---B--|o-E-BM?M-o--B|B-?-----BEoo-B--ooME-B|B-oE-MoBooM-B|E|E|-Eo?oE-B-B-EMBMMEE--o?-?B?foo
XXXXXXXXXXXXXXXXXXXXXXXXXXXXXXXXXXXXXXXXXXXXXXXXXXXXXXXXXXXXXXXXXXXXXXXXXXXXXXXXXXXXXXXXXXXXXXXXXXXXXXXXXXXXXXXXXXXXXXXXXXXXXXXXXXXXXXXXXXXXXXXXXXXXXXXXXXXXXXXXXXXXXXXXXXXXXXXXXXXXXXXXXXXXXXXXXXXXXfXX
