oB-o-o-?-E------M-B-o--BB-o?-M---?Bo--??---MB------o---BBM-?-o-??oME-o-?B?-B--ooM--M?EB-----o-M---B?--ME--E-Mo?--?-EM??--MB----B-Mo-----Bo-BMM----E---M--B---?--MBM------M-EMoMoEoBM--o-BB---BoM----o-oo
--oB-M-M?-ME-B-M-?o?oMB?-Eo---B--------M?-BE--o-oo--oM--?--M-BoB--o--oM-----o-?--B-o--?--M---o-o-oBM---?o-B---E----??---?-o--?BME--oM?E-----?-M-ooBM----B?-oM-E--oM-oMo-EB-?B---M-o--??-M--M-BMo--B-E-oo
-B-----B----Mo-o?o--?--??B?E?EEM?-oo--M--EM--M--M?---------B-----MM--MMM-B--B?M--B-BB---o?MM-BME--------E?E-Bo-oM?--o?oMMEB?-Mo--EEB?M--M-BB?-?ME--?o-MM----Eo-E???B-M-BB?-MB---o?----?---BE--MMo-o-?-oo
BMo--oo?--B--?BoB?oo-M-B-o---MBE-----M?o--MM?B?o-B?----B---EME-oM---E-o----M---MM--?BM---o--oE?----?---M-??B-M-o--o-?---?MoE?oBM-?--?M-o-BBMMMo-?--E------B-B?--M--o--EM--?----oE-BM-E--?-oM-ME-----o-oo
M-?o------------M---?-ME-----o-?B-B?-EM----?M-?--------?---??M-BM-B-M-?-Mo--?oB?oB--o-----BM----BE---Bo?----MBE-------BBB?-M--BM-EME-M-----EBBoE?-----BoB---o?-B---B?-B--o--MoE--o?-MB-MEE---?M---B---oo
-BM--M?---BMMM--E-B-B-----oBBM-?--BBoM-B--o-M-EoooM---oB-B-E-?M-----EM-BMEM----?o---?-?--ME-B-oMMB??-??oBoo-B?M-?M?oo------o?EB?-?oB--BMM--BMo-?----o--B-E--o--o??M------E?????-B-M?-?--BMB--BE-E-M-M-oo
-B---M----M-MMooBo?--oEB-?---??Mo----?MM---o---M?----B-Eo?--?-----M?--???--M-o---B-o-oM-oEMB--oo----o---B-E-o-M--M?B--?oEE-B----o--M-o--o-?-?B?--oo-MBMB--Bo-MB---oMoB----------M-----------B--?MMoMo-oo
??---o-Eo-----oo-?BBE-BBo-?o-----oMB-o-?-oM-BB-BMMoB-B-BB-----MMM---B-ME--?M---o?-M-EE-?---o-E-?-M-M------B-B------M---BM--M--oo?----?o-M?--?--o?-oBB-B---o-B--E--o-B?M---MM-?BM--oE?oM-B--ooM----??ovoo
E-oE---M-Bo---o----o---BM--?-oooB-E-Eo--o?--oooo?E-----E--??-??o--oo??-?-ooB--M?o-MEB-ooo-E---M-------?---?o--Mo-?E-Bo-M-Mo-??M-E?-?----ooo--o-BoBoM-o--MMB-BME--E?-Eo---E--ME----oM?B-o?------MM-?oofoo
B-??MMM-oo-?B---MoB?o-?BME--o-o---B-B--o?o-?M-------oB--o---E-B-M----?---BEoB-Mo-?-M--B----o?----B-??Bo-?M?--o---EBM----o?-??--E-M-o?M?-MBEEoBE--M----BEMEE--?B-BBEo?-?B-BBBE-MMM-BoM--o?---B--MoMoBEfoo
-o-----?-E-M--ooE-oM--B--BEBoBEMo??M---E-----Mo-oT?--M?-BB---M?-----M?----B----Eo------o?o-??---o?--?M---B-E?Mo----?E-o--oB---oB--MBo-BM---M?-?-o-oM-?---M?-----B---M-BE---o--o-M-------?B---??o-M?--foo
----BM?--M-?EM-E--oE-M-BMEM-BM-B-o?M?Eo-----oM-o-|?--o?----MBB-E----o---?-B-B????oo-M-BE?-o---EMMo??-----BoM-M?EBM---o?---oooo-B--?E----o-o-o-o--BEEM--o-B--o?-M-M--o?EM---MoME-o--E--BB----oo--?Eo-ofoo
-?----?Bo------B-o-BEo?-MMo-BB-----o--B-?-BM-B---|-EBM-B------MB-B-EMoB--BMo-EM--MB---B?M-E---?MM--M-oMM?E-?MM-?-?-BM--MM---E?-BBoM-----oEM?-EEMEM??-BE-o--E-E-B--?o--M-M--o--MMB----oEo-oE--oM-EB-M-foo
?TT--B--B?------M-----------MB?M?E?o-ME---B-E?ME-|-?M-oM-oT---M?-MT-T---E-T?-B--M--MT-B?oBBBM--ME?-?B--o?---BTT--E-o--o---T-?o-----T-----M--B-T??-E-?-BT----BB--o---ME-?M?T-M--T-EE-B-MEE--BooooBEo-ofoo
m||-B-o--MM-o-E-MoMMM--oM-o-M??E---oMB?EBM----BM?|-EE--B--|-EBB--o|o|B-B?-|E??-E-EoB|-B-B?oo-EoE-o-ooo------o||o-MBMM-oo-E|----E-E-|?E?---M-oM|MEB?M---|Eo?-----E?E-o-?oB-|-oE-|oM?E-oB--?oEB--BB-BE?foo
XXXXXXXXXXXXXXXXXXXXXXXXXXXXXXXXXXXXXXXXXXXXXXXXXXXXXXXXXXXXXXXXXXXXXXXXXXXXXXXXXXXXXXXXXXXXXXXXXXXXXXXXXXXXXXXXXXXXXXXXXXXXXXXXXXXXXXXXXXXXXXXXXXXXXXXXXXXXXXXXXXXXXXXXXXXXXXXXXXXXXXXXXXXXXXXXXXXXXfXX
