B-----ME-BoE-Mo---BM--B--oB-BM-MM--Mo--o--EE---------BE?-MM----BE-BMMMM--EBEM------??M??M-oE-?--o?-MBoMo-EM?B----?-----E---B-M-?B--?-oM---B?----BME--o-MB--B--o--M?BB--oo--E-?B--M------o-?-o?------BBoB
Mo-oM-MBBB?M-?EoEBMM?o??o----B--E--EMEoM----E-oo---B?M-?BB?--ooM-M----?-EMM----B?---??-o-?-?o------E-?-?-B--BM--B------?o-----?M-oM-M-----o-?B-BEE---?-o?o?-?MM--B?-M--M??EMEoBMM?MM---oM------oEB?-E---
?--EBBM--M--BBBM?M?-M-MoM--MEoE?-Bo--B--?EM-?-----Eo?E-o-M?-M-----o-MEE-?BEE--oE-?M-EBM?-MB-?-o--o-M-o-B----BBE-BB-M-E--?-M-----ME--MB-o--o?B-???-M--o-B---E-MB-oMM--EB-----MM-M--M----E?-?E-oE-?E------
-EMMo-MB---??oEM?o-o---o--o?MoMo---MB------oME---B-o-?-?-?---B-MM-E-?---BB--o?-M-o--BE----?MB----M-?---Bo-M-?-BBMBM-EB--EM-E-MMB-?----------M-ME----oEoB-?-?-B-BMM-?-MM----BoME---B-EEo-EM--E-M-----o?B-
--Bo-B?------o--oEE?M-BB?M-BMM----BBBE?BEME-MMM-oB--?E---?M----?-o-------oBBM-MoE--B-B--oBMoBMB?--?------B--B---M--o?M-BB--M-E---B-B-E---M-?M---E-ME?--MoM-?MoM---?oB-EE--E-B--BMBBB-?-B??----?--MM-o??-
MMM--B-E-o?-ME-BM?M-oB-?-?Eo?-MM-E-oBB---MB-???MM?EEo-ME?---M--?---?-M--oE-o-M--M-B---EB----M-o----M-EE-oo-oB?---?---?o------BM-BB----o-Eo---M-oM----M----oE-BE-?---?--??--o--oo-oEE?oB?----EE-?MMo-?E--
oM----M?--?o-----------oBM-o-E??--M-ooB--M-?M-M----?--E-?-ooBMMo-o--B----M--BE?------B?o-Bo--B---B-E-MMEE--o-o?-oE----o--MooB-?B----Boo-?-B-o--BMoo--?Mo-EBBM-B-o-M-E?--o?o----M--?Mo-B-M-o--B---B------
-oEo---M---o-B-B-B---o??-?B---BBooE--B-EoM--B?----MBEB-Mo----M--E?M-B-?BM---M?M-B----?--?Mo-o-MM--B?B-EM?oo-E---BB---oEB?--o--MB-B?-?E-EB-----B---?-B-?o---M-E-MoE--BM-BM?-M---o?-M???---MM-M?o?EM-M---v
MoM?-M-B-EBoE--B-Eo------B?---?--B?-o--B--o?M-o--M-oB-?-E-BE?-------oo--o----?---o-B-B?oMM?B--BB-----M-E--B--?-oo---MMM-oE??--o--BBE-BBB--M-?----BB---?o--?-M--B-M?-E-E-?-??-M--M?-MB?E-B--Bo-MoM?EoE--E
---E--E-----BM?-E-M---BM--MM------oo-----??oooo--o------?M-M-BE----B-E-BB----?--BM?MME--ooEM?Bo-B-?--M-MoBo-E?----B-M-E-o--o-E---MEM------??B------E--------M?-BB--BMMMo?----M-o-E---??M---BooM-M--M----
MB?BMBM-?-?-E-B-?-E-----------M--E-o--M-ME-oMoo--B--B?-??MB-o-?--MMo-?oEE-M---EB---o-M-M-B--?-EB--o---MoBB-o?E?-M--M?B?o-?o?-M---??oM-MBB----MM-----Bo-M---ME-----E---M?oo-M---M-?-M-----?---BEE?EM-?M-B
---EE-M---M??BE---M-----Mo---o---?M---Eo-?------EEB-M-M--M--??E-o--o-E--BM--BB--oo-?B?-----oBB-ooB-?M?----o?o??-M-------B-Eo-o-M-oMMB-M--o-?--MBMo-?--?B?B---B-B-o--?--?--E------?EEBMMB-B-Eo?M----EBE??
M----EBBoM--?-MMB----BTo-ooo--M---B--BM--E----------MBM----MMo-B-o-M-----?-?oo---?--?-?-E---M?--M--E----Mo------Mo---?Bo-oBEM--Mo?B----o---o--Eo-BM----o-E-o??M---?---M?---B----E?-MB--?-MoM?B--EB-?o?-E
-MEE?MM--MEB?BB-o?-E--|o-o----TBE?BMB---o?-B?o-EE?-BB---M--M??-?-M---Eoo-B----MB-??-?E--T---ME---T-M-T--?M?o---oo-Tooo?--M-?-M-M--M-oMTo-?TTT-Mo-T--B?-ToMB-o--EE?--T-EBB--TB--TBoMMT?--B----o-B?--BB?-M
mEBMoB---oBMoEo-o?--oM|?MBBo--|MMo-oE-Mo----?M-M---BEMM-o?-----??M-BBB--oM--E-?-oBoE???-|BE--?oEB|-EM|M--B-BooE?-B|EE-E??-E-E---?oM--?|--?|||BM--|-E--o|oE?o?o-M--B-|???E-?|?Mo|-oB-|M?oMBBBE?-Bo?-oBooM
XXXXXXXXXXXXXXXXXXXXXXXXXXXXXXXXXXXXXXXXXXXXXXXXXXXXXXXXXXXXXXXXXXXXXXXXXXXXXXXXXXXXXXXXXXXXXXXXXXXXXXXXXXXXXXXXXXXXXXXXXXXXXXXXXXXXXXXXXXXXXXXXXXXXXXXXXXXXXXXXXXXXXXXXXXXXXXXXXXXXXXXXXXXXXXXXXXXXXXXX
