M---?BM?--EMoE-B--EoB-?EME-BoM--B--M?---M-?-EE-M--o-?-E-o---MoE---oB----o?----BB--M---EB---?-?M?-B----B-B?--MBB-Mo--o-ME-----Mo--M--oE-----EM-BMM---BM---o-MBooBB?o-M-B-M--B---B---MB-M?--------MB-E--oo
MB-?-B-B-B-oB?-o--?--?-MBB-E--?E---------MMoBB---oMM--M?M---?MMMMB-??-Bo-----E?-------B-BM-B--oE---?E--E--B-BMB-M?BMBB?--B--E--BE-E-MMoB--BM--B---E-o?--?--BoE-Mo----?------?-o--B----o----B-o---BB---oo
-M-o---MM-oo-BoB-ME?M-M--M??M--MB--MM---BEo-oBB--?-?--M--o---o--o?-MB?-?--?--?B-MoEo---BB-o----B--EB--?-oM-MMBM-B-o?M-MBo?--B---Mo-MM--E--MoBE-BooBE-?-E?oo-?Bo-oB-EM??---oE-oo?--o--?Eo-EoE-?-BE-MBo-oo
----Eoo---MoMBB---?B--E-oo?--Bo---o---E?EMo?-MoB-oo--?--Eo-B-M-??o?-MoB?oo-o?E-B?---oE-?-BM--o-B--?-MB-B-B-?-???-?E?EMBo----B-Mo--?M--B----o-M-BE-?M-o-ME-o---MMo---MoB--E-??-MB?--M--B-?-?B--EBB-M-M-oo
--M-B--MM?-?----o?BB-B??-o--BBoo?o-oo-?--MB--o?---oo?--oMMoM?o-?-E-oMM-o-M---MMMB-M-MM?-B---?-?-ooEBoM---?-o-E?o?-M-B--M?-Mo-M?---M??o--oo---?-?M?M-oB---o----?M-BoB-M?-BB?M-o--o-----?-o-B-o-?-M--E--oo
B-M-?-?----MB-M--M--??--o--E-----o-EM?M---M-o?--?-M-E?-o---E-Mo--Bo--BMo?-oB--oMooBBoB---Bo--Bo-MoBo-o-MB--MB---EE?BE---MB-o--B?--?---?B---?-M-B--?B--M--o--o?EB-MMooo-----EooooM-M-o-B-M--BM----o?---oo
--EE-M--?--EB-?--?B-BMo--B--M-B---o---Bo--MBBoEB-MM-?-o--M-B-M?---?--o---B--MB??M-?-?-oB--E?-Bo--M----o---M?EE--BM--Mo--BEBM--o-oM--oB--o-B-Moo--o-o-EE?-?--------?M---?M-o---?BB--?E-?--B--E-E-MoBB--oo
-oMMooo-E--M-------?o-M--B-B-?M?--E---o--ooM-M--ME-MMo--M--E?E--M-?M-??oM?MM---Eo---?----?B?o-E-?---?-E---o-M-o-MEE-E-M-----oo-------o--E--MB?-?M-MM?---?B--MEBB--B-?-o--M-M-EBoMB--M--MEB?E?B??MM-?-voo
M?E?-o?-M--?oB---M?--o-B-M-o-E-o----B--?-----B-?o-?-?oo-ooo-------o?-BME-MoEMB-?-oB-M--BB--MB-MoE--B-E?E??B---M-EM?-Boo---?--?M?-BoB-oM---ooMB-MM---M-B----MoBE?---B-oM--MBoBBM-B?oBMM--B-?---o?EM--Bfoo
EoBB-?-M-E-M-M-M-M-E--M---M--B--oBBE-?-BM-M-E-B--E-----MoB-E-?---B--MBEMBB-?oEBB---Booo-------?---E?--B??o-M?B--??B-o-?o------M---?-o-----Mo?-?-M-MB-oo-o------EME--E--E----o---M----M--MoME--o-BBMo-foo
B--BE?---Mo---o--?E-o----BB--?-?-MoMB--M--??Bo-M--o---o--?B-oM-oE--?-B-MM?o--BEB-E-M-oo--?-?BB?B----o---ooM-?M--?--MM--o?-M-oE--o?BoM----o--E--E-oEBB---B----oEB-MEEM---?--E---Eo--BE?--BMo--MoBo-o--foo
M?--M-M-Bo---o-oM-M-B-----oB?--?------M-Mooo--?o--o?--E---B--?M----?B--??Eo?M-BEB?MM-o--Bo-o??---Moo---M-B--ooE-M--oo??-o-M----B-M---B-ooB-E-M--?-BM--?-??--ooBM--?Bo?E-E--BMoMME?Bo?o--M-BEM---o?-oofoo
o-oo-o---?ME-BE--?-Bo-EoBo-oo?-oMTE-M----M?o----??o?oMMoo-o--------?o-o?EB---M---M-o---o-MM--o?--MM?BoBMoBMo---B-ooo-B?M--M--M?oooME-----ME?Bo--M-oB?Moo--B-oMB--E--M?Bo-M-BE-EM?-----BB-EB---oMoB---foo
MB-T--M-M---EB?BToTToB?--B--T?-o-|M-?EoT-o-B-TEoB-o-----TMMoME-oT--?-----T-ME-M-M-oBTB?BE?TT?-TMoB?-TMo--?oB-MET---MooT---T--M--BE-?TM--E-BBoTM-oMB?TMT-o-B?M-MB--o--o?--BTE-?T--BE-o-T-oTT-B-oTMM-o-foo
mME|-M-MB?M-?EMo|-||-MMBBMMM|o-oo|o---M|EM-B-|--M----EM-|--oB-o?|M-E?EoEE|-----oEoBo|MBo-B||ME|---?o|-M-MB?M-?M|--Eo--|B--|?oo-M--BB|-BB-E-EB|E--?BE|o|-?--B---ME--o-M--Bo|BoB|oo-?o?M|--||oo?-|M-M?Bfoo
XXXXXXXXXXXXXXXXXXXXXXXXXXXXXXXXXXXXXXXXXXXXXXXXXXXXXXXXXXXXXXXXXXXXXXXXXXXXXXXXXXXXXXXXXXXXXXXXXXXXXXXXXXXXXXXXXXXXXXXXXXXXXXXXXXXXXXXXXXXXXXXXXXXXXXXXXXXXXXXXXXXXXXXXXXXXXXXXXXXXXXXXXXXXXXXXXXXXXfXX
