-------------------------------------------------------------------------------o---------------------------------------------------------------------------------------------------------------o--------
-----------------------------------------------------------------------------------------------X-------------------------------------?-----------------------------------------???????------------------
------------------------------------------?------------------------------M------------------------------------------------------------------------------------------------------------------------------
--------------------------------------------------------------?------------------------------------------XX---------------------------o------o-o-----------------------------------------------------??-
--------------------------------------------------------------------o-----------B-------------------T-------------------------------------------?-----------o-------------------T-------------T---------
---------------------------------B-----------------------------------------------------o------------|-------------------------------------------------B-------------------------|-------------|---------
--------------------------------------------------------------------------X--------------------o----|-------------T------XX--------------------------------------o--T-----------|----------T--|---------
--------------------------------------------------------------------------XX------------------------|T------------|--------XX-X-------------------------------------|---T-------|----------|--|--------v
----------------B-------------T---------------X--T------------------------XXX-----------------------||---------X--|T------XXXX-X------------------------------------|X--|---?---|----------|--|X-------f
---------------------?????---M|------------------|---------------------X--XXXX----------------------||----X---T---||-----XXXXXX--X----------------------------------|XX-|X------|--------X-|--|--------f
-----------X------------------|------------------|---------------------XX-XXXXX---------------------||---XX---|-X-||----XXXXXXXX-XX------------o--------------------|XXX|X------|---XX-----|--|--o-----f
---T---X--XX------------------|------------------|---------------------XXXXXXXXX---------------T----||--XXX---|XX-||---XXXXXXXXXXXXX------------B--------o----------|XXX|X--X---|X---------|--|--------f
---|--XX-XXX------------------|------------------|---------------B-----XXXXXXXXXX--------------|----||-XXXX---|XX-||--XXXXXXXXXXXXXXX--------------------T---------?|XXX|X------|o-------X-|--|M-------f
---|-XXXXXXX----------X-------|------------------|-----------------M---XXXXXXXXXXX----M--------|----||XXXXX--X|XX-||-XXXXXXXXXXXXXXXXX---------------X---|-------T--|XXX|XX-----|----------|T-|--------f
m--|XXXXXXXX---------XX-X-----|------------------|E-X------E-----------XXXXXXXXXXXX-------XXX--|---E||XXXXX-XX|XX-||XXXXXXXXXXXXXXXXXXX---E---------XX---|-------|-E|XXX|XXX----|X--------?||-|-------EX
XXX|XXXXXXXX---XX--XXXXXXXXXXX|-------XXX------XX|XXXXXXXXXXXXXXXXXXXXXXXXXXXXXXXXXXXXXXXXX-XXo|XXXX||XXXXXXXX|XXX||XXXXXXXXXXXXXXXXXXXXXXXXXXXXXXXXXXXXX|-------|XX|XXX|XXXXXXX|XXXXXX----||o|-----XXXX
