---o-------?oo-o---M-?Eo-B--E??--M-B-?-M-?oo---?o-?oM--?--B--Bo-M??MBMoE--o?-MM--?--------BBE-B-Mo-MEo---E?M-oEM--E?---o--M?o-M-o--MB?B?M-M--o--MoMEEME-MB---o--Mo---MoBB----??-------B-?------M-??-oo-?
-?-oo-----M-BE-ooM----BB-E--M-M-oB-?-o---oBMo-?E??-?ME---?-MM-o-----M-B------?--M?BBo--?o----BB--B-oM-?E??-B-o??-EMoo--o--?oM-o-B-?---oB---o---?o?EB--MMoE-M--oME-?o-B---E---B--Eo?-E-----?--Mo-E------E
-BE----?--o?-B----?-M---oM----E------B--BB--BE--E-B---M-Eo--B-?-o--?BM-E?-------MM--BM----o?M-oB?o--EM-B?o---MB--B-?B?E?-MMooooM-B---?---BoEoo?B--MM-?-EMB---M-??-B--B--B--M---E?MB-MMM-B-----EE--o----B
-B??o-MM-?o-M-M?oBB------?-BEE-MEo?-BE-oME-o?-MMM-?B?-?--EB--M?BB-o-o---o?-B-?-M----o--o?-?-??-o----BM-M--MBMMB--B-EBM-ooM--o-Mo--?E---?-?-?-??oo-----M----B--?MMBB?--------o--M---?-oo-E-o----?--B??o?-
o?-o----M?--?E-o---Mo-?M-o--?-?E--o-??--oMM?---B--EB?-B--B--ooM-B---ME--??E--o-B?BM---o-?B-B??-M--?B--?Boo---MEBoo-M?MooM-oo----E---Mo---M?-o-o---E-MBMBo-?o-EM-----M----E?oB-M-M-M-------M?B?o---B--oB-
o--E-B----M?E-MM-E?Bo-ooB?-EMB?M--EBMB--B---B----MB?----?MBoo---Mo----------?--oo-?E-B----M--o---EB----M-B---MM-M----E----?o--B-------?----?---B?o?--------o-?oBM?B-B-----MME-o----oo?---M-?-E---B-?o---
M?--Mo--o---Boo-o---EMo-?-B--Bo?o------o-o?BM------B-B-B-o-BE--M--M----o?--Eo-M?----o---oE--o-o--M--BEoo--oMB--?--E--BE-?-------B--oM?MM--E--B-oB----Bo?------oMM-o?B-BB?---?EoB--B-B---o?--?BE---?E-E?B
-o--M-oMMM?MB-----E-------o?E?M----o-B-o--o-?o-M?-oBBoM-o-?---MBBoB--E---E?BB-BM-o--M-BBoM--B-----oEM?oo-MMo---o-M?---BoEBoo-M-?o--E--E-M??M?o-B?MoM-?-oBMB?-oB----?-o--M-B--MMo-?M-E-B-E--MM-M--?B--M-v
----MM-?-?MoM---o-M-M-----MM-?E?-Eo?o?---BBo-----o---Bo?M?-?-M-oB-?E-??-?-Moo--oB-o-?--Bo-o--?-oB-?-?MMB-B---Bo---M?----??-EB-MBB-o----oM-oM-M?-??Mo------MM-B--?-M--o-MB--Bo?-o--E-BB-M--E-EB-?Boo--o-?
----M---o---oo-o--------BB----BB-?BB-M-B---Eo--?MB----E--BMMB-----E---?M--BoE-Booo--B--M-B-MoB-M-M--M--?-B---?MoB-B-M-o?---?oo-M-o-?-B?BM-M--BB-?--o?--oEoB--oE?-o?-M-?-M-EBEoo?BE?-??---?--B-B-?--EooB?
--oE?-B--?B-BB--oM-o-?oM---?E----MM???M----?---B---E?E---B---?MBM-?BM----oBB----EM-BMoo---M?-?-oE-M-BMoB-o---B?---BM-o-?M-E-o?----MM--?--E---o-B----?--?M--E--M-oB--------B-M-E---?-MMM----oMo--oMB-?o?-
oB-?o-B-B--B?-MEo---E-MM-E--?-B-B----BBE?MoE-----B??MB-M---o---Eo-?BBMB--M??----M?-E--BoMM--o-E-B?-E-B--?-o--B-B-E-B---?-o----?---EB-?-?-M-?MBo-?---B---B?EB-----M--B--?--M?E--BM--M-o?MMEo?----?------B
--E-Eo------M-MMMMB---B?-Mo-MoE-E?--o-o--MM-------?----BBEM---oB??-----EB-oMo----o--BoMBM--BE-BEo--?-MM-M?--o--o-?---BB----T--B-?o-E--?Bo-EM-B-M-?o--ooB-MMo??oo-BB??-o--?-?--E--E-Bo-MM-MBE--o--o-EE?--
-B--M--o--oT-o-oM---BTMB---oE-?T---TBoBMo-?-?-----BM-E--M?--?B-?E-B-T-o?-ETT??-------ToT-----oo?---oEo---B-M-BoTEEM-B-BE-M-|-E-----M?-oTB----EMM-TM-B-o--TM--ooB-Mo?-----?TTB?---?----o----?--Mo-------B
mEM-oo---B-|E--oMoEB-|?-?B--?o-|--M|--?-MBEB-BMB??--?-EEBBo---M--?--|E-BB-||-E--MMo--|B|Eo-B?E?M?--E-MMoE-M---o|?B-?B--?-B-|MMEo-E--B?o|?---EB--B|?M???E-|o?BMB-MM--E-Mo-?||MMMM-?M-?ME?EE-MooM-?----o-o
XXXXXXXXXXXXXXXXXXXXXXXXXXXXXXXXXXXXXXXXXXXXXXXXXXXXXXXXXXXXXXXXXXXXXXXXXXXXXXXXXXXXXXXXXXXXXXXXXXXXXXXXXXXXXXXXXXXXXXXXXXXXXXXXXXXXXXXXXXXXXXXXXXXXXXXXXXXXXXXXXXXXXXXXXXXXXXXXXXXXXXXXXXXXXXXXXXXXXXXX
