ooMB--MB--oB--?-Mo-Mo-M-M-oMB-Bo--?-B--o--M?--?--B-o--B-MoE--E?BBoo?oo---M-B---M?-?-Mo---oB--M?-M--EB-E-E-M--B-BB-M--oB---oEMo---o?M?--??-?oB-B?---o-?o----oo-M--o-M----E----M--o??BBMB-----E?--ooo---oo
M-o--?-B-M-M---oEM?BB--E?M-?Mo--ME-?B--oo?Bo-E-??oE---E-B-?BM--?-o-o--oo--E?------?--B--o--EM-o--?-B-o-E-?M--------?-oMM-B-?----o------E--M-BE--oBB-?M-E--E----M-?-BE-oMB-oB--?-B--E-EMoo--?---B--B-B-oo
---oo--B---B---B?-B---o--o?--B--M---BMo?--B-o--M-??M-M?----E??--o-o---M?-MB---o-M----BB-oM--oB--Bo-E-M?--B-----o-E---BBB-?-Mo--?B?E-o--BM---oBMB-EEM---ME--BE-?--B--?o?-BoM--ooMo--M---?-?--MBEEo--M--oo
oooB-M-oo-?MBB-?-EMB--BoB?------B---M-M-----MM?--MB-MBoo?--BMMM-Eo----oB--?o--oo-B--E--MBE--?-M-----B---M-E-B--Bo?o--oB-oBo-----M??BM-?E--oE?oBo--BME-M?M-----B--?M---B--?--------M-EoMM-?oM--??--EB--oo
--ME??-E-B?-E--B-Bo-?Eo-B-?--o---Bo--o-?B-EB-EB-----BB??--o-MM-EMo-Boo-?-o--MM-?M-o?-E?--??--E??EEMo---?EB?---------------MM-M?E---E-BBM----MBo-EB-M--EoE-?-??----?E-MB-o---M-o??-?BM----oBMB--?--B---oo
----M--B?--o--?BBEMoo---?-E---?--Bo-??--MBM--BE-B-M-?oo-----MBo--?o-B--EM?E--?--?-oE---o-M?ooM-EB?---oMEM--M---B-------EBMo?--M---E---M-E-M----oMBo---M?M-MM-------?-M---o?---?MB--o-?-BB-Eo-?--?-?-E-oo
B--o-----?---M-??-o-B-E----BE-Moo?-o?-B---?-EE?-M?oE-M-o----?-Mo-?-?Moo-o-M-o-MEB?-Moo-M-?B-M-??M-B?-o?--------BB---B-M-B??B?-?MMM-----B?BoBB--B---oM--??M------M-M----------oo-BM?-ME-B---E?-??E--?M-oo
EM-ooMEEMo-oM----?-?---BM-?--B-?-B??-B???BMMMB-MB---?--MoM-o-?B--EEo-MB-MM-M---M-M--M-M-B?-EE-M-?E-Bo-o--oMoMMo?-------B--B-M?---B-?-----o---M?-o--?-Bo-B---oB----Moo-M-M-M--EM?o-??-?M--MEME--E-o-M-voo
-MM---M-MMoo--o-B--o--M-------------MBo--o?-?-?M?M----B?---B-oBB-B-o-o--B-o--oE?-?B-M-?--M-M?E--B-?--o-----?MM?-B--???M-o-M-E?--o--oo-o-o-E----BM---MM?E--M-?BB-----B--?--oo-??----E-----MMoM-o--M---foo
?---??-?--B?-----oBE--M---M--o-B---M-o--M----Eo-B--BBBB-oo-E-?E---------o-Mo-----M?E---B-oE--BB-EoE-E?--M---o-MooM-o-M---BoMB--o?Mo-o?M-B-?B--MM---E--MME-oME-?M-o--E?--E---E-E---E?o-oo----M-B-oB---foo
o--M-BME---??B-o-----??--M-Eo-EB---?o---M--MM--MM---?-M--BBM--BM-oB?-M--?E-EM-o-M-M--oBM-oM?Bo-?B-?-B-oo--BMMM--?EB---M---ooB-E?M---MoMEBB?o--?o--o-M---B------Mo----------EMo--?-M--oB--M--M--B-M---foo
---?---?-M?-oo--o?--??-?-oMMBo?--B---?BoBB---Eo-oEE-BEM-EEB----oBB-B-??--BM?M--B????o?-E--EM-B--Mo--BoB---B-M-M--B----oEB?E--M?M-o--oE?--BMBEooE-o-BEMB-o---M-E---?---M-B?-M--?-BB-M?---o-M--oB---ME-foo
---M-BMMM--B--?--?Eo-MMo-M-MM--MBo-E-E-?---B---?-B---B-M-MMo--oo-o?oE--?oBoM---o--M-oo-BooB-?MBMBB?--EE-oooTME-M--o-MM--Bo-M-B-M-MTM----BM-TB-?-?B--?---EB-----?oM?-EB----?-BooE?--o------ToBT-o-M-M-foo
BMTo----M-M-TEEB--M-o-o----?-oE--oB?o?MMM--?o--BEMEMM-o?o???MMo?T-oT--E--B?o-?--MEo-M?E--BM-B?--Bo-T--To-B-|-?E--MB?oTooME?BBT-oET|-T--o-Mo|BB--?MT-T-MoB-T-M-o?Eo-o-?-TBToM--oT-E?oBBMoTB|-E|-MoM---foo
m-|----BooMo|-?--o-EE--B-B-?Eo?--oME-EM-ooo-o--B?M?-MEEE-M-??-?M|M?|EoMME-Mo-o-----oo-??--?Eo--M---|E-|----|?oM-M--oo|-BE-EMB|BB?||o|-M?-ME|M-?Eoo|-|-M-Bo|-o--E-B--B-o|E|ooB--|--?-BoEo|-|E-|-EooEMofoo
XXXXXXXXXXXXXXXXXXXXXXXXXXXXXXXXXXXXXXXXXXXXXXXXXXXXXXXXXXXXXXXXXXXXXXXXXXXXXXXXXXXXXXXXXXXXXXXXXXXXXXXXXXXXXXXXXXXXXXXXXXXXXXXXXXXXXXXXXXXXXXXXXXXXXXXXXXXXXXXXXXXXXXXXXXXXXXXXXXXXXXXXXXXXXXXXXXXXXfXX
