--B--oooM?ooBBoM-oo--o--BEoB-?o-MoM--?EMB?B-?oBB?B----o?o-BoBB-?oM--o-----o--o-?o--?o--B-?o??o-?-?-oBB--?-oo?-MoM?o---M-M?--MB??--E?B?--?-----EM?---B?-?M-oM-MooBo----o-ooo?-EM--Bo?B-M------o--o-E??-oo
o-?--M-?Mo-B--B?--BB-?-?oB--E--oM?BB-M--M?oo-B--oMo-MM---BoM-o-EMoooBM--?E?B-oMEE?E------o-o-?Bo-B-o?-----o----Mo-EM-?B?-?-?B-o?M-?--Mo--o-?-MMM-MoB?BM?EM?oM--?----B-?BooBBEMMB?o-B--oBoEoMEo---B-o?-oo
B-?M-?--?B?----E-B?oEBE----B--B--E?-oo-?--?-?-Mo-M-MBoo????M?B-?MB-?-M-?M?----oB??BE--ooBoE-oE?--B-B?M--?oooMEo-o-MoME-o--BB--M-??-B--B??oBoMo--Eo??o?--BBBo?o--?o-?o---E-?oBM-oM---??M?----MMoBM-o?--oo
---?--M--M?Bo?B?Eo?BB--oE----o-B-B--B??Eo?oEE??-o?M-o?-o---B-?B?B-?MM-?BEMB--E-M?MM?---?--???B--MBo-M?-B--?o-M-?B-o-oB?B?---oMM----?BBB-?MM-o-o--o-?oo?--BBo-o-?o-M?-??-M?oE-E-oE-BBEB-oMEM--o-o---?o-oo
??ooBBM--o-o-o?oM-?E---?BE---MB-B-M--??BB-ooMB?MoooE-?M-E-oooMBoo?B-BMB-Mo----MM?oM?-----MoEB?oo??-o?-?MoMo?MB--MM-?o-MM-B-M?--o---o-?---B-o-oBo--?-o-?--?-?--Moo-?o?-EB?E???M--?-oo-?--M?-B-?--?o-oo-oo
--?oM--o-Mo---?-o-??oBo-o?BoBB---EM-----B--M?E-E-oE-??--?-?-B?-Mo-E?E-B-?Bo??M--EM--EEB---?MB-???-o-B---Mo---B-Mo-E?o-MBoo?M---?-B---M---o?---BB-oMBo--BEooBoB-EBo--oB-o--M-?-?-oB-M-E?oo-M-?o--EE--?-oo
--MB-o-?B-Mo?-MBMBo-?o--ooBo--o-?----ME-EoEMB?--BB--?M-B--M?-B--o-MB?ooB?--o-B--?-EB--Bo?-B-oE?-?-oEoo-oBBo-M?-M-?oMM?B-oo-oo?o-o?-?MM--oM---?-o----o-??B-o-??-?o-B-E?BooM-?-?MB-EoMM--M-BM?-M?--B-MM-oo
-?--?oBM-B--B-?--???-M??--BB-E-?-oB-Bo?B?-MMo-M-MEE-B-B--B-M?M?-oMoo-M-?EEE-o-----M-o-BoMo--B??o-B-ME--?B-M--o-o-MB?--MBo-?---oo-oE-MM?o--?--B-B-oM?o-oM-oMEBB-B-Bo-Mo-B?-?---B-MM?E----?M--B?---o-B-voo
o-Moo-E--MMEo-oB--o???o--?-?-B-BM?--o--M-?o-ME-??BM--?M--o?o--B?oE-B-Bo?-BB-?MBoB-B---E--???Mo-EMBM?------?-Eo-ooEBo-o-o-?oEoM---EB----B-M-B---?EMoo-?---M-?o-?-o-?BB??-?----MoMooM?-MoB-??--?---E-BBfoo
?-oM-M-ooB-M---?BE-B--B?oo---o----MMo-?--?o?oMME---?o-oE-o-?E?-o--o-EB?-?--B-M-B-B----M?---ooo-BM--E--?--?M??Bo?-?oBoo--o?-?EE-oM?oB--o--BM-BMBo-?o--oMo?B--M?-oE-o---EB--B--??Mo-o-EBBBoMB-Eo-B-M-Mofoo
-o---?-M-?B--M-Bo?-?BM--E--M-B-M-oEB-?MooE-EM-M?--oB-M?-o--B?o?EoBMo-?B-------?o-M-EB?--?oB?B-o?--BM?-o?-B-M-?--o--o-BME?o-MM?-oo?Mo?Moo-Eoo-BM-??oB?B-B?o--?oo??-M-o?----?-o-M??-o--M-o-B-o??-M?-M-Efoo
o??E--oM--?-M----?-BoM---B--?-MoBoBB?BM?-?-??---oMEo-Mo--?Bo--o-o---Mo?-oM---o--?oE?-?---?---o?o-o-?BoM--oM-oEB-B-------?o-o?-??-EBB-?-B?-oMB----oo-?-o-o-MoM--Boo--?M?---B-oo---o?E-oE-o?Mo-MooE-MEBfoo
oMo--M-MMEo-?-E----?Mooo-BB--BEo--B-M-oo-MM-?----oMo---oo-BoB--???o-E---oM?EBo--BEB--E--o-BB-M----MB-B?MM------B-o?oo??-B--?o?---B-M?--?EEB?E-o-EM-BBE?M?--Bo-EoE-oo--E-o-E-??o----M-MBM?-o---M-?-o-ofoo
M-----o-?M--?M-oo--M-?o----Mo--o-B?M-oE---o-???M--o-o-?-B-----B--?BE--?--???-o---?-?M?BE?--M?-??M-oM-----M--?M-E--E---?-?o-----EoB-B---EM----MM?MoBB-B--o?EBE-?-?o-Eo----E?E-B?EEE?-?oE----Eo-?--MoM-foo
m----------------------------------------------------------------------------------------------------------------------------------------------------------------------------------------------------foo
X----------------------------------------------------------------------------------------------------------------------------------------------------------------------------------------------------fXX
