-E-?-----o--B----?B----B-----o-E-?BB?M---B?--M-M--?-EEE--ooM?-BM?o-B-M-M-E?-B-?B-EM-E----B-Moo--M?-ME---B-o-?-B?B-----?--B--B----?-MME-?o----Mo--ooM--?--?B---E?---?E----MMEE--B-B-M-?Mo?E-E----MM----o-
o-------MM--EE-BEE--o-BoB-M-----E?M?E?oE-MM----o-BM-M-?E-BM-o-E-oooo-MB--MoB-MoM-BoE?o---EoBo-BM?Mo----?B---EoM---E--o---B--Eo-o-----B--Mo-----M-E---M--?--M------MBM-??E-E??-B-oBM---MMo?-?-?--E---MB?-
o?----BoE-MM-?B?----?-o--?Moo-?EBM--BM-M-BB-B------B?--?M-oM---?------M?--BB--???B-BB?---BB-?B-----M-BM-?--BME?-B?Bo--?----o?-ooE-M---?BB--MBM-o-?M---?E-----oMo------??---?-oM-B?-M--B-MBMB-Mo??-?B--oE
---B-?Bo?o-M?BM---?--B--B--?--EMMMBME------E--B--------?-M--?o---o----BE--------o-----------EM-?M--MEM-----Bo----o--Eo?o-EMM--M-BBMM--B-M-o---B?----M?----o--BMoo-MM-?--o?-BM??B--M--o---??MMM??--Boo---
?-B?---BE--BB--o-B-?oEo----E-o--?-MBMB?---oM--?M-?-?o-E-o---EEBM--?M---M-MM-oM-M----B?M------o-?-?EM??---oM-B--oooooMBB?---?-?B-M??M-------ME--BoB--B-EM--M-?oo------?--E?-E---ooo-M--E???-MBEBE--?-?-?-
--?-BEooB-?-?o?--?-MM?--------B??-??oBB?-?----E--oMM--B-Boo?-B?M-?--B-M--E-?-oEE?ooBoEo-?--o---BEM?MEEB--BBM-MoB--o---oo?M---?BBooME---M?----M?-o--oM---B-B-E--o?oEE--E--Bo-o--oo-----?---B--B--M-oooo-B
---M-???EM--Boo-o-E--o-o-?B-o-M?EoB--BMMo-E--oM--M-B--o-o-o?-BM--B--M?--M?BBM-MBE---M-------B-M-----MMoo-ooBMEM---??o--B?M-?--?B---?--oo--oE-oo--?o??-EoooM--EE--?MB-??o---oo-MoMo-?--------B-B-M-?---?-
--o-MEM?M--M?---?E-E---oM--B?--BM-B--oo--MM-o-----E--B-o-M-M--M--B----?-MM--BMMoM---MBoMo-M---??----M--M-?---M-?--E-EE-B--o--EE----?--MBBooB-MBM-----?--??o-EMME-B?EM--MMoo--B??o?-EB--o-E-?-?----BMM--v
E-M-M?---o--B?M--MEBM-o-o---E-M?M--MM----o?Mo?E-MEBMM--EBMBB-EEE-BEE?--Eo---o--E--B-oE--o-o?--BB--BB---BM----BoM?BM?M-o----o-?M?--E--MEBo-E-?oME-----?-----o----BMEMB-E---Mo--M--M-BE------?M--?BME--?-E
M----oMoE---?oM--B?MMM?--o----------B---oo---BBE----E-M-E--?B??----?BB-Mo-EM--E-M--?-Mo-------oEB-o--M-----o--oEo-?-M-o---B?M??-?-BB-EBEo-B-----o--oM---o-oE---MMoMo--?-o-M-E-MB----B-BBMEoB---o----o???
?--MB?-?-?---E--EoBMo-M----M--??BoM--oBE?-o----?o?-M?E-M--oMo-E-oo---oB-MoMMo--?oo-B-E-E-?B?---M?o----Mo------EM?o-M--E?o-BE-------o--?--o-BM-??M--?---MB-MB--E---?---E-------ooE?E?BMoooM?oMEMo---oM--M
--o--ME-E-E-M?B-MB?o----?-M-oMo--E??E-?BB-Mo?----MB--B?E--o-o--Bo---?o-BB-??-E-M--M?BMoME-?oE-??o-?oM-o?--BM-oM-?-o--?B-E-o--oB?-E-E-?----B---??-E-ooE-o?-----M-----oBM-?-BB--o??B----?E---oE-BBo-E--?-B
?-EME--o?-?ooBBMo----M---M--o----?--?B--M-B?B-M?--MMo--MoEMM--oE?B--------Mo?---oM-oB--MMMM-?-?--?-o--?oME----?-MoM?-?-----?---M----B-M?-E-BE-?-?BEB--?M--oo-BE--B--MBE-B--E----BoB-MoMME-B-Moo?---EB--B
Bo?MB-EB---?-T---?--oMB?--o-M---TMM?--EBoT?----B-To?BT-o?B?--MoMB?o?--??-Mo--Mo-T-M--BT?-?-B-?TM-?o---MEEBM---M--o-E-?M?--MB----?-M-o-MMEM--Bo?--E?--TB?EoT-MM-MBBT-oB-o-----ToT-E--T?TTM?MME?o?-M-MME--
m-BBo--?E-EEo|oBMB----o--?M--MEE|-oB--?oE|-E-E-ME|oE-|-EoMBBo-E?B-M-M?oB-oE-B??-|-oo-B|-BME---|--B-EEEo-Bo-oB?-Eo?BMMo----MB-M-??E----?M-EMBEo--o---B|o-??|Eo--M-?|ME-o--ooMo|?|-?o-|?||-BBoM-EoBB-oo-??
XXXXXXXXXXXXXXXXXXXXXXXXXXXXXXXXXXXXXXXXXXXXXXXXXXXXXXXXXXXXXXXXXXXXXXXXXXXXXXXXXXXXXXXXXXXXXXXXXXXXXXXXXXXXXXXXXXXXXXXXXXXXXXXXXXXXXXXXXXXXXXXXXXXXXXXXXXXXXXXXXXXXXXXXXXXXXXXXXXXXXXXXXXXXXXXXXXXXXXXX
