E-oM--M--M-oM-MBM--o?MB?oM-?-?-M-MM-?----?--B-----?--?M--E?--MBEM--M--MoE---M---MoEMB-o-E-Eo--o--M-oM---MM--B--Bo?--BMB-BMo-o?M--B?-B---oM---B----?--M-MM-Mo---?oEE-o--BMM??--Eo-E--?M--?-o-B?-B---?M-oo
?ME-?-Eoo--oBo--o-?------MMoM----BoB----o-?--E--?Eo--EB--Boo---?------E--MM--?BMB?M----M-?--o---M?E---?--EBM-E-----M-B?o------B--oo-MoM---Bo-EB--E--M-?o-EB-EME--B?-o-BB----?-M---M---o?-E--?B----M---oo
--M?----EB?-?MBM--M-E---M?oB-B---B-M?-o---EMoB--o?---?-------E---E--B---BMB-o-M-B--?--?M-o---M-o?-M--E?-B-M--MB---?M?M-?-EEMo-o?-B-MME--E-MB-M?M--E-o-M-M-?-ME?E-o------EEBE??-MBM-----BMB-B-B-?B-B-o-oo
?--B--M--?BoM?-EM---?-M--oM-M---M-E-?oo----?o---?---Bo-ME-oo------MM--B-M?----Mo-M-M---?-M-BM--E-?--BBM--BoB--oE----M-M--??BE?o----M--ooM--o---?M?Bo-BEE--M------M--?--oB-M??---MBEo-EM-o???Bo-EoM----oo
--M--E--EB--??-M--M-Mo-----B---B-EMEoM--M--MBMM---M-E---M-B----?Eo??-E?o-----B?E-?EE-E-??-o?---B--MBE-BE-----M-B-MBoMBo-?-??--?-o-?E------?-M------oMBB?---B?--M?---?-EEB-?--?M---M--M?-?B-M-B--?ooo--oo
E--o-??M-B-o-M?E-B----o-E--o----B---E-B--ooM--?---ooB-?E--B-----?---BBM--M--?-M?---MMB--M--?-B-?BM--ME-B-o-----BE-oB-E-E-?-BB?E---B??-?Eo-?---o-E-MB-BM?-EM--oE--oB-?-BBE?B?---?E-M--Bo-----MMo?MB-oB-oo
B-E-------?--M-M--BoE--o----M?M-BMo-?---???--B-----o?-?B?----B-BoEB?-?-----?-B----BE-MM-?oBo-?oMB----BB??E?M-?-MM-?EEB-?--ooBM--o--?--?BB??o-EMB?o-B--E--BMo-EMoo?oE?-B-B--B--------?MBoE?-oB-oB?Moo?-oo
----M---Bo?--MoBM-MMB?MB--oM--?M-Mo--oB?-----E---?----?---EMM-?-M---M-?E-oE--?-Eo--?-o-?o---??-BEEBMB-E-BMME-M-oM-MM--o?-?MBooo-E-M-----?--M--oM?MM--MMo---E-------BMBM?EEo---BB-M-EMo-oMM-oMM--ooo--voo
M?oEB?BM?--M-----o---E---oM-BB--Eo--B---oo-E-?-o-B-----o---M?----?-Mo--BM---B?-M-M--M-B?B-M--?oM?--Eo-?BM--BB??M--BBBE--?-?BB--BM-?o------o---ooo---M--Eo?----?E--o-M--B?-o-?M?o--oBBE--o?-o-o-o-----foo
----?-?o-?-M--?-o----?---??--B??B-M-----M--M?M-M------MBoo-EB----o---?-BEo---E-M--M-?MBM--EB?BoM--?M-?---E---M-M-M------MBMo---?----M?ooM-B?M--MM---oEEBB-B----Bo?---EE----?-oo-------M-MM?MB?--MMM--foo
o-oE---BB?---B--M-B-BMoM?MBB----o-?--Mooo--B--?-B-MME?B?M-o??ME-MM??oB--M-oMM-------oB?Mo-?---M??Mo----B-M-E-ME?MBM-?Mo-E??oB--MM-M-E---------?MBEE-o--Booo-B--?--BMo--B?M?---MBBo-o-?---?--B-E-oo-E?foo
oEoMBE-B-B-?-o-------B---o?M-M--?oo-M----E---o------B-oM--?--?BE---B-?BoMoB-M----o--?-Eo-M-B-BE-?----MBo-o-M-o?-o?-EM?B---EoM--M--EoBo-----B?----?-Bo-Mo?-M-??--oM?--?oE--?-?-M?oM?-BE-B--Mo---M---BEfoo
-Bo-o--?-M-Bo?-MB----M--ME--E-----E???---M--o?o------MBMBBEM?--?Eo---M--Eo-oBo--M-----MBEo-o-?MBME??MMMo-oo?EoM---B-M--o---B-B-E-M----oT-E??-?------BBMB--o----E??oB---?o-B-?o--oB-B-?MT?T-?EMM---?-Mfoo
M??-TM-??M---BT-BMo--M--oTooBE---M-E-T-BEEM-o-MM-TEB-----M?ETT---?----BoTT---B--M--B-TME?MMBo?-BB-TM-M-?MTBE-----Bo-M-ETMoB--T--T-B----|o?-TEE---T-o-?-oEM-oB-MBM?TB-B--M-oTooMoB---M-E|o|?-Mo-E--BBofoo
moo-|-----oMMo|Eo---EME-?|MoEBoB--?-o|EBB--E-o?B?|---BE-BB-?||oE?Eoo?BM-||MBEM-E?-oB?|-----o--?-?-|EEo--o|M?oBEE?E-Moo-|-ooEM|?-|-BM--o|???|?--o?|BoBEM-MBBMME---M|oo-BoEE?|EB-BM-o--oB|-|-----?BE-?ofoo
XXXXXXXXXXXXXXXXXXXXXXXXXXXXXXXXXXXXXXXXXXXXXXXXXXXXXXXXXXXXXXXXXXXXXXXXXXXXXXXXXXXXXXXXXXXXXXXXXXXXXXXXXXXXXXXXXXXXXXXXXXXXXXXXXXXXXXXXXXXXXXXXXXXXXXXXXXXXXXXXXXXXXXXXXXXXXXXXXXXXXXXXXXXXXXXXXXXXXfXX
