--?M----oM-oo-M-M?--?----B-E--?M?-oM?--Eo-----?EM?M----B--B-oBMooM--E-BM---M?-oB-?-EoM-MBoB---?oM-E--EooMoBB---M-MM--?---Eo-B---M--M-B-Eo--?o-MB--EE-Mo--MoBMB--M----M-?oBM?M?-M-E--M-B-o?MM--M-BE-?M-oo
---oooo??-Mo-E-M??--MoE---o---oM?oMMMBB-o-oo-?E----E??o-o-M?Eo-E----M-EB--M--??E--M-oB---?-??-E--o--BM-MBM-BoE--?Mo--B-o---o?-E-MB-MMM-M--M?B?-?M--M-B?o-M-B--MB--oo-BE--Bo?B-?o-B--BoBE-B------oBMo--oo
--?B---MM-?MoMooB?---E?B-?------oB-MB-Eo--B---MBM-???M--oMoE-Mo?-?o-B---MoM-B-oM--?-o-?-o?oo-----M---Mo---??E?-o---Mo?-?---?-M-?o?-B?-E?-?E-----MB-B-BBo-B?o-------MMB--------?oo-----BBoB-B-o-B-o--o-oo
-oB---o----M-M---M--EB------M---B?-?--?-E---M--M?-o-EBM-----?BM?-oooMMBoB-Bo--------o---BBM-BB?---M-B--oB---B-----Mo-?M?ooo-B-E-o-o---?B---???-o------MB--oB----?---oo-?B?--?B--MM----?--??o??MB?--EE-oo
E-----?B-oBoE?-E--?---o--oMMM-?MMMM----E-ooM-Eo---?-M--oE--oM?M--M?---o-o?-BEB-M-B-B---o?-BoM-M-o-E--?-?o-MBMMoE--MB-?-B--o-ooB?--M??E-------oMM--oBo-BBo-?-B-----???B-----?MM-E-----oB-?MM-M-o-Mo-?M-oo
?B?----MME?B---B----B-?-EMBBMoo-oBo-?E--oE-oB?-M--M-o-M--M?--MB-BoE--?---?--M-?--B??---Bo-BMBoM----EBoMB-oo-?-o--?-M-----?MEM--?--------o---??-B--E-B---oM-E--?---Eoo---B-ME-o-B-E---M--Eo---E-M---M?-oo
o?ME----BMB-E-B-o-B-BBM--?---o--M---?Bo-B?-EBBoE?-B--B-E-oB--M---o?-o--oB--?-o-o-MoEM-B-M-?B-EBo--oM---B-B--oooM-M--o-?-EMM--?--??-o?-?E---M---------?---Bo??-?o?-?--oM?--EM-o?----o-E-oBEo-o--?M--o--oo
M?-B---M-MoMB----o-BM---?-?---M---?-B-M?--BM--o-B------BoEE--BME-?EBE-o-B-?M---??E-M--EoBo--?MBoo-E--oM--??-?E-B?ooB-M?-B?B---M----M-?-Mo-?o?--oo--?o-B?B--B-E--BM-BBoMo-o-M--M--o?MB--?-?B?B--??----voo
---BBM-M-Bo-?o-?-E-M-MM----o------?-M-o----E-?--E-MoB--o?M-o-?B-EB--?--o-E?----B?B-M-?M--B-MEM----BEMME--EBBE--B-oE---Bo?--ME----?M?B?-M-B---?M-o-B-B----?ooM?E-M?-Mo-B-Eo-ME?-BM--B-B----oBoB-B---Bofoo
-E--BEo--B---?E--M?o?M?--B?----?---?o--B-?EB----B--EMMoMB-B--?--BMoM-B--??--B-B----M-B?oo?oo--o-Mo?-E-?-M-M-?-oEE-ME----o-oo?B-o--E?----B-?------o-M-----oo?Mo?----oo---M-o-BB----?-E-M?-EE?-B-E--?M?foo
o?-E-B-Eo-B-?oMB-MB-?M-E-oB??o-BMo-E--E--o-E?-?--?--?-?-Boo-M---EEoB-EoEM------?-?--oE---M-BB-BM?-Mo--MM---M-E-M?MBMM?-Mo-MMM-oM--Bo-----oB-?B---EMBM--B---EM--oB--oB--?--B-?-?EE---B-Mo---?-o-?Mo---foo
--o-?--B----Bo-oT-BE-?-M--??--?B-?---M---oM-?oE-ooMoMB?ooBo-?-?TB--ooB-MM-B-?Eo?-Mo---oo-oB---B-M---M--?-M?--?---o?M----Mo?-BM-oo--?-o-EEBM-B---oBE------B-Bo--oB-M-----?--BM---MM?--o-------M-?-MBo-foo
-----oooMo--oo--|MM-?-??-??-?EM----E-M---B---M--o-?oooMoo-o-M-o|B-o---M-----MM-o--BM-?---B-?-----E-----M--oE--?B--B--oB-??MMB-MM-oBMBEE?-MoM?-o-MB?----B-BM-M-Mo?o--Boo---Eo------MM--Mo-o?----o-----foo
--BMM-B-Mo--?M?-|MoMBBMo--TMEMB?-----M?--?T-B-o?BTB--MTo-??T---|-o-o?oMBB-T-TTM-?--E-o-MT?TB----B-?---E---MB----M--o---??B-oMM-TB--?-MT---EM--TM-MM--TB-BM----TM-ETo--o?B-?--o--?M?---EMEo--M-BT?B?-Mfoo
mEB-?-?--E-o?---|---MB?oM-|----o--?E-ME---|E-BE?B|--B-|oE?E|-MM|--oMBE-B--|?||?BoooBE-oo|-|--E-?EBo-?oBo--?-oBMMBooooEE-ooBE-E-|--ME-B|--?M---|E-B--?|?-E-BMMo|-o-|B-?-BM-?---o?-o----?---BE--?|BBE--foo
XXXXXXXXXXXXXXXXXXXXXXXXXXXXXXXXXXXXXXXXXXXXXXXXXXXXXXXXXXXXXXXXXXXXXXXXXXXXXXXXXXXXXXXXXXXXXXXXXXXXXXXXXXXXXXXXXXXXXXXXXXXXXXXXXXXXXXXXXXXXXXXXXXXXXXXXXXXXXXXXXXXXXXXXXXXXXXXXXXXXXXXXXXXXXXXXXXXXXfXX
