M-?--Bo?--o-?-M?B---MM-?-MM--B?----E-??---M--E--?BoB---BB-EBMMo--BB-?o----B-?MMB--MB---M-BooM--?-o-o-oo-EM-oMB---------BM-?---?Eo---Mo-?-MB?--?----oEM?-o-MEM-EoM??--B---?M-o---?oM-o?-E-o--M?-M------oo
---E--M??-o--MoMB-BMB--M-B-o?--B-ME?B----B?B-?-o----MMB-?o-oB-----oM---E-M-?--?BM---oM??--B?---M--?-EM?-?B--BEo--oM--E--M-MMMB-MBo-o?--B--E--?-Eo----oo-B-B?E-B?M--?-?M-B---M??-o?---MB---E-B?--oBooE-oo
?---o-B---?-?--o--E?--??o--E?MB?MM----------?MB?-M--M----?----o-E?----M??-----MEoE------o--?-?--oB--B-?-MM-BE--EMBE-o-?oM-o--B-?--oM-?EB-----B-?----MMo-BoE---M?M?-M-M----EMMB-?o------Bo-B---o-?-EBM-oo
-?-oE--oo?-MMEM-o?-E-----?--BEBoM-o--BBM---B-?---M--o---MM?---E-?-BMB-B-o----BE-B------oB?--oM--M?-??ooB---B??E---?o??-E??--?Bo-EoB-o-Mo-Bo-?--Mo-E----oMoM-?---B---E--EMo--M-E-??E-B-E-----oM??--B-E-oo
--o-BE--MMEM-M-?M--BBM-E?oo?MBB-??-o-oo---?--EM-B?--E--BM--MM--B--oEo-MB-E-B--M---o-?MMBB---M---EoB?-Eo?oE--??M-BM-?--E-E-ME--?-?-B?ooB-B?---?B--M--Moo?--B--?B-B?--B-?-?oMMoB---?-B-o-E------?ooM--B-oo
-EB--B-----EBoEM----M-o-----?---EBo-M-o--??---E?--oE?--M-?EMEM-E--oM-oE-o--?BooEM-?----E--o?-M---?--o-o---oEMM-----B-EMo?-B-oB-?----B-oMo??-B--M----E---E-BE-?---oM-o?oB--E------oBB-oMB??-EMoo?o-E-M-oo
-M----ooE-oB-----MB----B-o--MMEMB---M-M--oB--EM-B-o-M-Bo-oB---M-M-ME-------?-MB?---?-o--o-M-oMEM--MBEM-?-E--EMo--o---?B---EMo-MM----?--MMEo?EB-B--B-?---B-?MMEo-MMo-B-oo--?---o-B--BM---?--B-MBBMM--o-oo
MoBM--o-M-o-?-?-B-oEBBo-?oM--?M?-----oo--M-oo?-o--B-?-?o--Mo--M-MB--MB??--M-BoMo----BE-M--M-?-?-E----?BMo-BMB-B?-?Mo---MBE?o---?-ME--M-BB-?o?B-o?o??--Eo--?M--??--B-Bo--EE-MBooo?--M-B?---o--B--EB--ovoo
EEB?Eoo--E---B?B--B--EBM-M-EMoE--B-?o-?ooM-Mo-o-o--o-Mo-B-o----?-oo-?----Bo-E?E---M-----M---ME?o-E-B?--?-Eo----E---o-oM-EBB?-----??oM-Mo--M-??MB-----B----MB?oB?oM?oBo?-------BM-Bo?--M?------------Bfoo
?----E---M-E-----M--?---?--MM-BM---E??-o-?B-?BoM--o?M---M--o-?-oo-?--o--B--?---?--oMEBE---B--B--?---?---MMM-B-B-Eoo---oo?--MBB--o-ooB----BMB----B--EB?MMo-oo----E-------o?M-----E---BB?oMM??--B-?-o?Mfoo
?oEB-M-M--?M--M-??-Mo-MooB-Moo-???MM---oM--MEE-E-MMM?oMo-MoM--EM-EM----o?--M--o--o?M?-?---M?B--o-?o---?M---EBE?-?--------Mo-?o--M--BoMo?B?--?-B?-E-M--oE-Bo---M?---MBM---M----Eo-oEBB?--M------o-----foo
-M?MME--o-------oB--B-oE--E---o--BB??-o?B----BoB--MoB--?--oM---oo----?--EoE--o-BM-EB---oB-B------oB--?B-E-B--?B----M--BMBo---??o----Eo-B-B-oMB-oB?B-?-----E-oMB----?-BB?oEo-BM--?oM?-B---ooEBooB-o--Mfoo
BB--?--Bo-M-oB---T-Mo?EBM------Bo-o----M-E-?B-oM----EB--E----?o-M?o-??Bo-EBo---?--MM-?-------oEE--oo-B?oToo----o-oM---?--ooMB-E-MM-oB-MB-M-E--EoB?--oMoB-E?oBM---M------B?BM--E?EE----E---MBB---B--oTfoo
-MM-T-?ET-M-T-M--|M-TE?-T--E-EBT--T--TTM-Bo?M?oBo??E-EM-M-oMo-ME-oM-?MoM?B---?E??---BEM-M-MTEMM?-?-o?---|-TM?oo-?o-o-B-BBMoETTB-T-oM-?---?M-?o----o--oT----M--EB--T-BM?----E--T--M-TTB-o?M----o-M-?-|foo
m---|M-M|E??|ME-?|??|MM-|-EB--M|o-|E-||-M-?BoooB-BMBB---M-E-B-MME?--BMM-M?-MB-BE-?M?MM-M-EM|?--B-MB?BE??|?|o?-EB--M?--Eo---B||-o|Eoo-o--B?--?oMo---oM-|B?Boo-oM?M-|-?--BB-M-?-|oEBB||MBMMEEB-EMBoBEM|foo
XXXXXXXXXXXXXXXXXXXXXXXXXXXXXXXXXXXXXXXXXXXXXXXXXXXXXXXXXXXXXXXXXXXXXXXXXXXXXXXXXXXXXXXXXXXXXXXXXXXXXXXXXXXXXXXXXXXXXXXXXXXXXXXXXXXXXXXXXXXXXXXXXXXXXXXXXXXXXXXXXXXXXXXXXXXXXXXXXXXXXXXXXXXXXXXXXXXXXfXX
