--?o-----?o----o?o-??--o-------o---?-?-?--?----oo---o-?-o---??---?------o-o---???-o-?--?-----------?------------o???o?----?--o----?-oMooE?oBB-o??---??-----?-oo-o-?-?-oo-o?---?-o-o---?--o?-??o-???-o---
--o?---o--??-------o-?---oo-----o?--?o--o---?-??--------??-oo-?-?----o----o--o?---?---?o-------o?--o-----?------o-oo?---?-----?oo?-?----oo?-E??-o-----------?--oo-?-?oo-?--o--o-o-?--?o?---?-?o---------
-?-o--?-?-o-o-o-o-oo-oo-o?-?o--?-o-?---oo-o--?-o-o?-oo?--------o--o---?oo---oo-?oo-?-o-?o-o?o-o----o----o-o????-o?-o-??o----?---o---?B---o??B---o?---?-o--o-?--o-o---o-oo--???---?--????-?-?-----?-oo---
-o--o-o-o--oo-----?-?--?--o-o-----?-o---o--o--?--o-???-?o--?oo----?--o-o-?o-?o?--o-ooo-?o--?o?--o?-?---oo----?-??--oo----?-o?o--oo----oE-oBE--------?--o---o-??--?--o?----o--??-?--o--o??-?-----?o-?o---
--o--?-?------?---o----o-o--????o-?-?--??--o--o---??--?oo-?---o-o?o-?o---?--o--o-o--oo--???-------o--?-?--?----??-?o--o----o---o?----EoB-oMBo?o--ooo---?o??-oo---?---??---ooo---o?-o------oo--??-?o-?---
---------??-o??-o-----?---o?-?-o---?----?-o----?--o-o-------?oo?------?--o??o-----o--o-?--o--oo-o-?--?-----o?o-o-oo-?---?-o--o-------??BoM----oo--------?---o---?--?--o---?-------?o--?-?----o---o------
-?-----?oo--?-o?-o--?--oo?-?---o?--oo??-o?--?------?---------------o---?o--??--?o?--o??---?-o-o?-?o?----o---------?----?---o--oo-o-oB-B--?-oo--o--o-----?-?-o--o?---?-?---o----o?-o--o?---?-o-o--o?-----
---??o--oo-?--o-----?o--?-?o---?--?-o--o-oo----o-?-?o??-o?----------o----o---?o--o-?o--?------o--?--o----?o--oo?-ooo---o?o---o-oo-??-?-E?MoB---o-?-?-?o?----?---oo??o-o--?--?---?oo--oo--o---?-o-o-?-v--
-?-?---o-o--o-oo??---?---?ooo-?o----?o---?-o?---??oo?--o?-o---?-o----oo?--??-o------?---?--?-o-o--?--??-o-??ooo-o--?-o-?o--oo-?oo--??Bo?oEBB--?--------o-o--?--o-o-o?o?--o--?-?---?-?-o-?---oo-??-oo-f--
--oo-?-----o------o------------o?----oo---?-o--oo------?oo-?--?o-----------oo??-??o-?--o-o??-o??------oo-?-?-?-o----o?---o?o----?--??B-oEoB--o--o-?---o-?-o-?---?-o---o-?----o-----?---o?-o-o-o---o--f--
----o----?o?o??------?-oo?o??-o?--?-o---o---o?---?-----?-o----oo-?-----o-oo---?-o------?-?-----?--o---?--o-o-oo----???--?-o?------o-E?BMB-M?B---oo?--o----------o?----o?-o-?--o-o----?o-??-o-?-o-??--f--
--??-oo-o---oo------o-o-o-?-oo--oo?--oo---o?o?--o?--?-?--?o---o--o---o?-----?oo--o-o?-??-o-??------o-??o--o?--??--------oo--o----?-o-o-B-E-o-o?---o---??-o----?--o-o--oooo?oo--??-?---?o--oo-??--o-?-f--
---?--?o-o?o-??-o---o-?------o---oo-?---?--o?o--?o-----??-?o?----?-oo-?-?o------?-o------o--o?----o-??-oo-o-?o??---o----?o------o--oB?BMEoBE??-o---o-?o-?--??o?o--?-??-o--?o---??-?o?--?-?o-?o--o---?f--
--o--??ooo----?o--?------o---o?-?o----o?-?-?--o?oo-o-?--?---oo------oo-o-o?oo??--o?-?o---o--------?-o--??--o-?--ooo-?-?--o-o?-??-?o-EB-oooBM-o-------o?ooo?-?--?-?-?oo--?--o----?oo-?-------?-?o-----f--
m--o--o------?-o-?---o-?-o-o-?o?-o-----o--????--??o----?-o-?o----oo?----?-------?--?-o-?-?---?---???--o--o--oo---o-o???o-oo---o--??o-MEBoo----?oo--??---?o-o-o-?-----?----?-?---??-?-?-?--o--o--?-?-?X--
XXXXXXXXXXXXXXXXXXXXXXXXXXXXXXXXXXXXXXXXXXXXXXXXXXXXXXXXXXXXXXXXXXXXXXXXXXXXXX-XXXXXXXXXXXXXXXXXXXXXXXXXX----XXXXXXXXXXXXXXXXXXXXXXXXXXXXXXXXXXXXXXXXXXXXXXXXXXXXXXXXXXXXXX---XXXXXXXXXXXXXXXXXXXXXXXXXX
