--B?-oooM?--BBoM-oo--o--Bo---M?M-?MoMo-o--????o---?MM-MMM?Mo---MB--M??MoMo-B?oM-E?M?--oEM---B?-MEE--??-oM?BM-oo----B?-?-?--BoEoo-ooE-E---?-?-Mooo-B?B??B-------?-o--?o--Eooo--?oE-o?BoM------o--o-E??-oo
o-?--M-oMo-B--B??-BBo?-?E-?----Eo-?E?B?o-E--BE-?-Mo?M-???B?--?EB--??-oM-BB-B-Eo?o?B----Moo--oBB?--o--o--?B--o?EM----?-o?-?-?-?E-o-?-??BB--oo-B---?---E?BM?E-ME-B--o?o-B--?-M-???-o-B--oBoE-MEo-o-B-o?-oo
B-?M-?-?-B?-o--E-B?-oBE---EMo-B---?-o???oB-?M-?--o-?--o?--o---Mo??-??--?o--o-Mo--BB-?ooBE--o---E-BBBoE-E--M-oo--???---oMM---oBM--BEMMMo-?E-BoB-M??-Bo-Mo-B--BM-o-o?--oBB-M--o-B--oo--?M?----MMEBM?-?--oo
--o?--M--M?Bo?BoEE?BB---E?--oB-E-o--B----MooMo?MEooo-oooE-BBo-?oooB---oo-?E-EM---?-B-?--Mooo------o???B--Mo??M?-MB----??-??oo?ooEB--ooo-o--?B-B--o-oMMoB-Eo--oo?M---oB-BB-oo--o?-?BBEB-oMEM--o-o----o-oo
??ooBBM?-o----?-M-?E---?BM-??--?-oM-ooo?E--B?--oM--B?-o-B??----o?oB-o-o?-oM--Bo-M??Bo-ooM-E?-o-BBBM-E-oM-----M??MEoMo-M---MB?M-EB-oM?oM----BM---ooMEMo-o-B-?E-o--EBEB---B--E---ooooo--?-M?-B-?--?o-oo-oo
--?oMo---Mo---?---??oBoooBoB-M-B-o-oo-?--o-?oMB-??-ooo----MB-o-BM-BB-o?ooMBBB?-E???M-o-?M-??-Bo-?M----?----BM-?--BoMMEB--B--oB-B?B-oBoMo----oM-??oM--ME--B?BB???B--B--?o-oM-B---M-?M-E?oo-M-?---EE--?-oo
--MB-o-?B-Mo??MBMBoo?---oo-oMo--Mo-Eo--o----M-MoMoB??BMo-?-M--Mo-?-oM--o--ooMo--o?-oMM?B-?---?-MBM-oM--o-?---o--B-M?-ooE--o---B?--?M----E-?-oo?--MB--MMo--o-?-M?E--o-?B---Mo-------MM--M-BM?-M?--B-MM-oo
-?--?-BM-B--B?---??ooM??oo-B-BM---o--M?BE-??M---Mo??ME--oM-EB??oB?--M-o?--?--BMB?oo-B?oB-E??oo-B-ooM?-E-Mo?B--o-?M?-?o--??oooB--M---BM-??MM----Eo?o-B-MM-E--M-------ooBB?B?E-?-o-E-E-----M--B?o--o-B-voo
o-Mo--E--MMEo-oB--o?-?----oB--o-?--Eo-?-BMo-EE?-MMEooM-??-E?-?-??M-oM--?BB---BoooMo?-BB---EM--o-E---M??B--Eo?--?--??-oM-??--BBBE----??Bo-?ooB-MB--oo??--MM??-?----o-?-?-EM-?---??BM?-MoB-??o-?---E-BBfoo
?--M-M-EoB-M---?Bo-B--B?o-?MBo--E-M?M-E?E--??---M-BooooM---o?MBB-?E-E-?oM-E-EBM--?oM-?--Bo??oBBM---o--oM--B?o-oMB-M-M----?--ME-?oMBM-?E?BB---MM-o?M--B?-BM-B-oM-Bo?o----M?---o??M?o-oBBB-MB-Eo-B-M-Mofoo
-E?----M-?B--M-Bo?-?BM-?E-M?M?M-?oMMM--?M--oE-oB-Bo-B-B??-B???-o-EBMoo??o?M-BooM?-o-E-BE?-Moo?-o-o?-Bo-?o-E?--o-E?Booo-B?E---M-B?oEooB--B---o?-?--------M?---oM??B-EE-BM-M?-?Bo-o-o--M---Bo-??-M?-M-ofoo
o??o--oM--?-M----o-BoM---M--?BooBoBBM---oMB?-M-oM-Mo-?ME-?-o-E?----MEMM-E?BB-M--oM?--o--M--oE--o???-BooMo-M-E?--oB-?-?-Mo-oB----???--E-BE-B---??MM--BMoM-oBo-B-MMMoM?--M-o?---M-?M?E?oEoo?M--MooE-MEBfoo
oMo--M-MMoo-?oE?---?Moo--B-ME-o-o--?-E?EE-o--?--E---MM??-oMB???-E?-?MoMoMoo-?o-----B---o-?Eoo?oM-B---B--M---o-B-B?MBo----?MM--o-----?M?---B-B---E-oMBMBBBM??--o-MB-o??M-oM-E--B----M-MBM?-o---M???o--foo
Mo----o-?M-??M-oo--M??o--?-----o??-o-??-M-E--o--??---MEoMoMB??------o--o--M-E-?B-BB----?-E-M---o-E--B--EB--oM--MB?M??o-------o-----B-?oB?-?-E?-oM?Bo--E--B--B-?-??-E-?-oo?B-BE??--?o?oo-?--E--?--M-M-foo
m----------------------------------------------------------------------------------------------------------------------------------------------------------------------------------------------------foo
X----------------------------------------------------------------------------------------------------------------------------------------------------------------------------------------------------fXX
