oM?MM--o---B--BB-EM--o--B?---B-M--o-B---MM-BM--M-o-o-E?-B?--E-B-M???E?B?--ooEEM--o-MBB-?--MBo-oEM---B---o-B----B----------o---B----oM--M---o-?-------ooE-----E----o-o-?MBo---?-M-?-B--B-o-?B-B-B-MB---oo
M-M?M-M----E-?---?EBo----Bo?-B---E?--E---MEo--?B--B-BB-MoM--B-BEBM-BM---oE--MME---?BoM--MB?---oB?Eo-oM-?--MB-?E?-?-BM-MB--?-M-M?BM-B-?-M------MM?oBB-MoB?o-EE?--o---Bo-BE-??-BBM?---o----E-B---B---o?-oo
--MoE-BM--B-??M--??E--B-o-o-oEoM-??-?-----B-MBEMB---B?-?-----?EM-??oM?-MBM--MMM--?E?B-Bo--o?o--Mo-MoBE?-?o-?BMM?----M--?--B-Mo---M-B-?------E--B-M--M?-B---MB-?EB?o----oB-BoE--EM-?Bo-BBoB--E-?Eo-o---oo
---o---oM--?-MBEE--??o----oBMM-M-Bo-M?-??oMM-o---BoM----oB--o-M-?oM--?-o----EoM--oBB?--oMo?--o?BB---M-M--oE---oM--M------?E-B?B----M---M?BE---?--ME--o-Boo---?E?M--?-?-o-oB---o?---?oMoo--E?--BMBE-oE-oo
-M--M?o??-E-MM-------?M--BMB--o-o?oBBBM--------MBo?E--M--o-o--?-?------o-?BoB--M-?-?--oBMoB--EEBo----BB--oM-?-o?---BBB??E-BEMBM?E-B?-----E-?---MM--E---?---?--???MEB-B-E-MM----MB--?-o-B-oM-?----M-o--oo
B-MM-----M?--?---o-?----?-?-?----M--o--?-E-ME-?oEMo----o-B?--oEBoME--M-EM----oo--?-o---?--?-MMBEB----?B-E?--E?--o-B-E?--B--?o-------?M-E-M?E---?--B--B?Eoo------MoM?B----BBMo?o---B?-?--oEo-?-oMBo-E--oo
-MM---Mo-M-M---M-Bo--BoMooB-B-E?-?E-M-o-B?-o?---B-MM?o--ME?--?B-MoM--M-?---?-o--oB?o--------Boo-o--B--?--?M---BM----?o-MB---o?-ooMB---o-?--?--M-BoBBEEM------MMM---EM-M--ooMEBBB----Mo?--B--------o---oo
-B--B-?EoBo-o-M?Eo--o-MB---o-??oE-BEooMo-----BEo--Eo-?MoEMB-?-?E-?B---BM-B?B-E--M---BM-BBo-M-M?B-?MM?-Mo??-?----?MB-oE--BEBo-EBM--o--B?--M?-M---E--B----??-MMoE?MB--oo-ooB??-MM-B-o-M----M--o-Mo-Bo--voo
-o-o-?BM------o?M--BBB-EEoMB---?--B---oo-Mooo?--?-?-?Mo-Bo--M-B??--E-o?MMB?--BoM-EBB-oo-EM-oMBEEo---o-?-o-E?EM----B-E---MM-ooBM---MBB-?----?---M--oMM----BM?B--o-EBM----Eo-E-B-BB--o-ME-B--?-EB-MBEB-foo
Bo---o-E---o---oB--B-o??-?---B-M-E--BB-----M--MoM?--o-o--B---MMM-E--EMM?-M-------B----B?Bo-M--M??-EMB-?---B-MBM?--M-B-Bo-------o?o-o----M--B-----MMo?Bo--MMEM-B-?ME---oB-B-----M?oE---MB---M??M--oMMMfoo
-M-E-E--?--E-?-B---E--oM----?--Mo?M-oB-----M--EEM?MB-----?Bo---oo---?-E-EMo-o--E-o---E---M------o--?-BBo--Bo------E---M?------Mo?-BoB----B-MB?-B----M-Mo--oBM-E--oBBBEBo?--?--?--?--?E?-BM-oo-EM--o--foo
E-M---B-?-o-BBMM--M-BEo-M------?M-BE---M--E----MB--M-?o-M?o-BoM-----?--B?MB-B-M-EB-BM-?-E-Eo--oB-----?--oEB-BB?M-----E-o-B---Mo-BE--oM-E----oEo--oB-EMoB-E-oM?ME--MM-MoM--EM-??o-----??-?-?BBB-BM-B-ofoo
Bo?M?-o-M-M---o-EEMM?B--?--?MoM--EE?MM?-oo?EE-o-M---M-BM?--oM?E--Bo--MoBBMoM--MM?-o?o-o-Mo?o--oB---BEE--M?M?-M?-Mo-oB--oB---Eoo--M---BE?--oB?BM--M-EB-B-BMM-?---B-B-BMBT?-M--?--o-B-E-BB---?-MEE--??-foo
MM?Mo-ET?E-B-EM?---B-B?-B-B??oBTT--?o-?EEo-?-?---o-B?--E?B-MMM-ooT?-oMTT------o--BBo-B-MT-oM--?o--M-M-M-?-?--BoMBMTBM---BT-TM-?-BoTE-o?M??BEB?---METT-o-T-?-BM-oMB?MT-?|EB--B--MBoT--?--oMT?-o--o-T-?foo
m--M-M-|oBME-?M?ooEBoM-E?E-BoEB||B-?--oB-B-E?-M-EoM-MM-?EM-M-o?--|-EMM||BME---B-E---EE-E|M--?-o--o?oM?----B--BoEB?|E-o?-o|-|-M--?M|MEo-EE-E?E-EME-B||MM-|-MoME-M----|EE|-B-E-oB-M-|-MBooMo|oBB-B-o|B?foo
XXXXXXXXXXXXXXXXXXXXXXXXXXXXXXXXXXXXXXXXXXXXXXXXXXXXXXXXXXXXXXXXXXXXXXXXXXXXXXXXXXXXXXXXXXXXXXXXXXXXXXXXXXXXXXXXXXXXXXXXXXXXXXXXXXXXXXXXXXXXXXXXXXXXXXXXXXXXXXXXXXXXXXXXXXXXXXXXXXXXXXXXXXXXXXXXXXXXXfXX
