o-o?oo--MM-?--o-?-E-E?----??BB-------?M?B-E--E------o-B--o---?B--B-M----B---ME-----?BME-BoooM?Bo-EoEB-oEE-?Boo--BM?o?BE-o?---o--EMB-???-B-o-Boo--?--??MB?--oMB--M--ooo-M?---BE-ME-E---M--EMo-------M?-oo
-?-o---BB---Moo?E--B-o-oB-o?-----M--BM-----o--------o-?-----Bo-?--B?EoM--o-?---B-M----?o-----o-M-?EMoo--?-oB?---??B-M--EBBM--M?--o?-oB---Bo-o-E---BMoB-M--------o--?-o-o-M---M--BEM---M?-----oBoM-BM--oo
-oM-M--?E----B-o-B-M-EE--ooBB--MBE-?---o-EBo?-M--Eo-B??BBB--BMo-----?B--?B--MMM-?Bo--oEB--E--?oB-o?-B--Bo---EBEM--M-o---?ME-?-B--M-EB???MM--o--o---?o---oB?-?B-o--E--M?o-B-?---oBMoB---o---oo--?BM--?-oo
o-M-----?-B-?o?o--M-M-?--B?--?---M---?MB-M-M-------?Bo-?-M-?-o?-M??MBM----E-oo----B?M-Mo-EBo-B----o---M?M-?--M-MMM?MB?-EB-Bo---o--oMEBM?B-E-----o-----MB--MEBo--MBMo-B-o---EE--o-M----E--ME?oB----o---oo
-M--B---oE-o??--o-?B-MBoB------Bo---M--------o--M-BB-?o---oEM-?-MEMoM-EEo-BBo---?-EM-B---?-M------E--oMMo---o-o--oEMBM-M?-o-EE--E?E-B-B?--M-----??-?-??--?M-------BBoo-BoM-???----?--o-----B-MMo??-??-oo
--MoE--M-?BEM-E?-EM---o-BEo-?----B-ooo---MooMBo?M----oB-M-E??-?o--B--MM?--oM?-BEB-?----MM?---BBo--?--o--BoBB?--M---?o?B---o-?MM---Mo--M?-B?----M-o---M-B-M-M-BEo-E-o--MEoMMMoBo----M-oB--B?--------Eo-oo
-oBEMo-?--MM?-?--??----M--Bo-E--E-M-M----MB-E-?--BM--B----M--E-MB----o-EB-??------B--oBB-B-E-?MM---o?o--?M---ooM------B---B-E-M----B-?oo-----BB-o???-?ME--oo-M?----B?-oMo-?-Mo---?Bo--E?BM---??o---?--oo
o-MM-?-?M-?--?-o-BM?---M-Bo---B-M-M-M-?E--oM----?ME--??---B?--M---o--ooBM-o?B----M--??--------E-B---?--?B----E?-oo----o?E--B?M?--oo--?--o-M--?-ooMBMB---M-B--?--o-?-B?-M-o--?----M?-----ooEo--Eo-?Bo?voo
-?BB-M-B---oMB--E?-B-M---E?oo-----M?M-M-o-MB---M--Bo?E--B-?-M-E--B-B-Mo--oB-M??-??M----BE--?-B--o--o--ooooMo?-??oEM--Mo-B--MoME?Moo?E---E-EEM---M?-??-----MoM?-oMoB-E-Mo-oE-M-B-BMo?MEo?-oMB---o--M-ofoo
o--??-Bo-M-?MMo-M-o---o------Eo-E-B-B-?B?o-M-o---o-M-BBM-oM--M-E--o----B??B-oM-M-----E-------?--M---o--o?-?-E-oo-------E-?ooM-M-M?-??MEo-o??-?B---BE-B---BM?-M-BMEooB-oM--B-?-BM--M-BMBoM-B--?-----?ofoo
M-BB-MMM-?-o-M-BoB-E-EoB-o----M---B-?oo-oB-o-BMoB-?M---o--M---M-------oM--MMB-B------?-BE---M---M-B--M--?-M-MB?M?-?--o-MMo---E--ooM--M-B?-BEB--o?o-?-?---?M-MooE-M---E-B-?--B?-oMEo?-M-?M-o---B-?MBoEfoo
E-M-M---------M-?---o?-E--o--oE-?B-?oM??B-?---??--M?-M-B--BMM?---B-oBEoBB-o---B--EMB---BM-M-??-BBB-oB--?----BoB-MB-oEM--?--o----B??-MMM??B-B--o-------?---oo-oM?-o-?-MM-?oMEo-B-B-----o---?----B-M-MBfoo
BM?oM-oB-oBo-Eooo?B---o-M-Mo-o-MoBEM-------?o?-B?M-o--MoMo?--?M-M-B-M--MM---M?---M----BB--T--oEM?--?-M-Eo-?oM--Bo?M-Bo-ME----B?E-o-BB-MMBo?E--?--?oo-----oM?----?BB?---E-B-M---?-MBo-?E--o--BB?---?--foo
-TBEBE?TE-o-T?-MMEM?---T-E--Mo-TT-Bo-M-o-??MBMEM-ME-Eo-EMBB---E--?TET-??--o-?---?--oME?M--|-BTB-To---BBTBoM----BB-?M--T--?T?--T---?-MEoBB-o---o--?o-B-M-------B-o-TBo-o-oTEBMBE-E-T?--BBM?-T-TE---TTEfoo
m|oMo-o|M-EM|E--BMoE-M-|?BM?--?||M?--MM?-M?--M-o?-M-----E?-oM?--?o|M|EoE-?-MBB---?o-B-E-EM|BE|--|oEoE--|-EBoME-EM-BME-|-?o|o--|-o-o-o?MMo--EEEoB-EBM---ME-?-M?-MB-|B-MoBB|-?----?-|EMEoBBMM|o|ME--||Bfoo
XXXXXXXXXXXXXXXXXXXXXXXXXXXXXXXXXXXXXXXXXXXXXXXXXXXXXXXXXXXXXXXXXXXXXXXXXXXXXXXXXXXXXXXXXXXXXXXXXXXXXXXXXXXXXXXXXXXXXXXXXXXXXXXXXXXXXXXXXXXXXXXXXXXXXXXXXXXXXXXXXXXXXXXXXXXXXXXXXXXXXXXXXXXXXXXXXXXXXfXX
