EB--oMo--B-oME--EMEM--?-M?o-?BB--?-?B--?--E-E----M-?E--?----?o--oB---oM?-EB--?--o--B---MMM--M---MooB----o?M-M-MM--?-E--BE-M-BM---BM--Eo--?--?----oE------oB-E--M--BMBoM-oB----o---o-EBM-?-M-?-BE------oo
-M-o-E-BMBB-E-Mo-MB-o--o-M-?--o--BEB?-o--o-M--?E?-MB----o-M-B?-B-EBMB-EBo?E------oM--EB-??o-oM?--?E-oo--?-o-B-M----?----?EB-B-o?----M?--BM?E-o--B--EBMo-EBEo?--?---M--o-MoB?o-Mooo-----M?o--oE-?B--E--oo
M---o---Mo-EB-B-E-E-??-E-B-o--o-MM?o?--?-oM--o-MB-B-Mo-----oo-M?-BEB-BB-E--B?-B---oEB--B-----BE--E?o-?--M-oo-oE-MMMo?----M-?--B-?-------B-B----o-ME--BMo--B-ooM-E--B?-MM?E?B--E---o-o----?BM-M---o----oo
o-E?M---B--M?-????--oE?M--E-oo-o--MEB--?o?E-Eo-----M-oB--?EoEB---?Bo---E-------E----?--?MM-EB-M-B?----?--o-B--B--?--M--B---Eo-EM-M--?-?--EMBM-MoM-MBMo--o-MEE?o-M---MMo?B---E----?---MMo-o----E?E--B--oo
o-B--?--MME-B--o-?E---E?--M-E---o-B??M?M--BE?-o-B----oB--EM?----?o?--------B---M---BEB--o---Bo-o-B---?o----?-oM??---?--E--??---ME----o?-?-MB-?M?----?BB--EMBM--o-BEB-oM-B----B---E?Bo-?oE-B?--BM?B--o-oo
E--Bo-o-o----oM-?--Mo-M?o-M-Bo-?oE-oBM---ooM----?---o--BM---BBM---BBE?--B-?EEo?-?--E--B-oB-EM---oo?-B-?--E-B--??-M---E??-o-oo?--?---Eo-o-E-??B-MoB?oB-----Mo-?-?E?----B--o-o-BBMB------??o-B?MBB----M-oo
?BB-B-M-M-B--BEBo-E-B---o----o-o--oo?--Mo--?-----o--M-?B-EE-BoB--M--Bo--EEM--oM-M--M?--?-oMBMoB?B?M---B?B?o-?o-MB?-o--ooE--E-----?-oMM-E-----??BM?o-EMB--BMBM---?M---oo-o--?oB--?Mo-EBBo--MMB-BMBE?---oo
o?EB--o--BM-M---E-BM--?--??-?-MBo--MB-----M--Bo?o-oB-M?MM?-B--o--BoM?-oBB-B?M---o---MB-M-----M-?oMME-M-o?-??-BB-o---------BM-E--o--Mo--?--E-----EB-----M-E-?-----?--B?-----Bo--?---oB?oBoM--?-o-M--Bovoo
M-?-M--B-o---B-o?oM---M--B-oo---B-----E-B--BBMB?-EEMoMoE--oEMo?-EoM?-B--B--M----E--oB????--MMB-?-------o-E--E-B-----E---Mo-BEMB--?o---M-o--o-B-?M-MBo-oB-MBM---o--o-?-?M?oE?oE-E--o?o?-M?BE-M----MoEEfoo
---M--EB-E---M-MM-M-E-oo--EM-E-BM-o-?MMo---?--M--BB?-?MMMM----o--?---Mo--o-----??E-o---B-oB-?-?oo-MB----??M-M-B-?-M-?M?-?M---M------M---M-?o---B-?-oB--o-o-o---o----M-M-B--B?-E?MBo-o-oM-M-EM-M?oM---foo
--o---?oo?-BM-o?E----?--B-B?-B-B-?BE--MB?-M---B?-B-?BB-----?-BEoo?o--B---?B---oEo-B---o--o-?----B-M---MMo-Mo-M?-oEoE--o-B---B-B-BMo--M?o--Mo--B--?o--E---Boo-oMo---B-BBo-?--?---MM?o-BMM--E--B-o---oEfoo
-MMMM-o-B----B-o-B--M-o-B---M-o----M?-ooB?B----BEo-BM-M?-B--?--?o?B?-----BB?-----MB--o-E--?--E----o-E--EM-Eo--M--?---BEM?B---BMB?o-?o-Eo-B?BMM--B--MEBo-?-EoM-o--o--?ME--BoE-----MBo-M---?--?MBE-?oo-foo
o--B-?--?------E-M--MoB--B----B---?M-oo?ooB-E--M-B?M-EMoMoE-B?--?o-Mo--B-----?------B--M?ooB----oo--?-??--M--?-o-E--M?--oB?BMMM?M-M--B--?---oo-B--M-?M--MB-BBM-BE-??-BMMo-B-----BB---M---?MBB??----BMfoo
-BoBB--TooE-o-------o?---o?E-oT---T--M-M---?M-TMTT?--?--TTME-oTTT----oo-oBM-MTB-E-EE--B-M---E-o-T----oo-TBM?---E-METo-?T-M-o----?-o-MToE?-BoE--?T--o-E--B---oT-M-o-Mo-B?EET--oBB-?--M-o-o--?--TM-??-ofoo
m-?oBo-|--MoM?-B-?E?o-EM-ME?--|E--|oB-?-o?--?E|B||--oE--||-MMB|||-B-B?--B?E--|B-?-M?E--B?--BMMo?|---B-B-|M-Eo--Mo-B|E-?|oE---oooB-oo-|--?EBEMo?-|--BE-Eoo-o--|-oMBM-BB--MB|BBo--o-o-Mo?---Moo?|BM--?Mfoo
XXXXXXXXXXXXXXXXXXXXXXXXXXXXXXXXXXXXXXXXXXXXXXXXXXXXXXXXXXXXXXXXXXXXXXXXXXXXXXXXXXXXXXXXXXXXXXXXXXXXXXXXXXXXXXXXXXXXXXXXXXXXXXXXXXXXXXXXXXXXXXXXXXXXXXXXXXXXXXXXXXXXXXXXXXXXXXXXXXXXXXXXXXXXXXXXXXXXXfXX
