-Bo--MB-E--?B-BMM-E----Eo--M-o----oo---?Mo--B-o?B?--MB--?-----o--MEBMM-E-Bo--oB-----oBMM--M-?Moo--?----Eo-BB?o---Eo-MB?-o-?-----?-B-M-B--B----B--M-----BB---?-----BBME---o?-M---B-o??-MM----E--?o-E---oo
E-----?-MB---B?---B--?-B-MB--oo-?-?----o-M-?B-?M---M-?E--B-ooo--EB?M-?MB?-o?o----?-EB-oMo?BEMoM-M-E?-EM?-------?-MM-o-M-o-M?-ooB--B--?--o--MB-?-oBEEB---BBB-?-oE-o-B-B-?---oMM?B?EME?Eo-EM--?-Mo-M--B-oo
MB--B?-MoEo-?o-E-??oEM-M-?B-BoE-----Bo-B?-E-oo--oBME?--BEB-BM----M--?MB-MBBMoMM-M?EMoEoBo--M--?o-EB--MoEME?-?--E---oB--EoBE-o-o-?MEMMB--o??oM-?-----oE---o?-EEo-M--------?o--?---Bo--?------?B-MB--BE-oo
----BB--?M-BoE-B---B-oE---?-EB--MMM--MoMM-B-oME-BBBBB--?--Eo--o-BB---o----oo---M?-----oo---M---oE?B-BB----?M--oME-oM-MB-Mo-B-o-ooo--MBM--BBE--o-oo-M?Mo--o-MM?-o---E--o--o--?M---o?-Bo-EMM?o-MMo--?---oo
o-oB---o---o-B-E-?-EE---BoME?-------?BoB--?M-o--?-o?-o?-E-BMooo-MoB--?--?Bo--o-B-M--M-M-------E--?EE-M---o-o-?oo-EoM?----B---B-?--ME?-B---??-?oo----o-B---MBB---EE--oo?-BE-o----?oM---oB??-?B--Bo--EB-oo
--o--o-o-----oE--BoBM-EM---MB-o---E-MBM-EMBB-?-Bo-??-o?-MEEoEM----oEBoB----oM?-o---M?o?-o?B-M-?-B--B--o-MoM---oM?B?BoB-o--?-o--?--B?-o---M-B---E---oBM-o-oBo-?-MM--BoMEo-?-----?--o-oE?o--M----B-BBMo-oo
M---B-o---BE-?----oBoM?M-E----Bo-B--B-----M-?-?BMBEM--E---M?----o--MBM--Bo--?MB--o-?---?-Eoo-M-------EooM--o-BMM-MMB-MoB-E?---?B---M-ooM----Eo-----oM?Bo-E--?--M-?--BM?B----o---?-Bo-?---Moo--------M-oo
----?-?--EEM-oo--?o-MB-B-M-o-M?o-----o---?o--B--M-BM-o?MM-M-----MEM-?B--o?---MM-o----BBo-----ooE---E-?BEooM-MMB-B?B?B-B-o-oo-----EMoB-MM-BB-Bo--M-Bo??-M-MoM--E-M---EE?---o-B-EM-B----B--o-M-o--ooM?ovoo
-B------EM-ME-Bo---o-B-M-MM--Mo?---E?oEB-----o---B-M-?----o-?--MoB??o--o-Bo-o-BM--BB-EE--------?---M----?-o--?--?BooBM-?---o--?-BBBBM-oB?-?B-o-oB-Eo-E-----M-B?--?-B--?oM?M----?-E----?M--BE?--?----ofoo
?MMoMBBE-?--?MMo---MB-B-EB-EB-BE?M-?--?o-------BME-EM----?-o-M-M---B?oEo-?o--BMo---?E?--o-MM-?-MEB?B-?B---B-oo-oM------E-M--?-Mo-?-o---oE----MM??-MBB?o---MMM-M---o-E--BB-E-o?oMo?-M-MM?BE-MMMo-BB?--foo
M---?-BMM-B-E?----B-B?-B-M-B?B-MM--?B--?---E-??-o--BM--E---o---o-?BEB--E-?-o-oB---?o-BMMMoo?-?MBMB--B-BE-o---Eooo--EB-BM-?--?-o-Eo----oo??--EE--B-E?M-M?o?---MEBo--o?ME??-?oo?B----M-MBE-?EEBoBo??--?foo
---E?B--B--MM----BMo??---B--?-------M-----EBMo-?---B?-?T-ME?M-B?Bo?BoooBo---o--B---M-?--oM-oEM-?-??--M---EB?o-M-B--??-?MM-E-----MBo-----M--MB---B?-BEMB-----M-M-M---oM?---MoM----?----o---B?M-BE-B---foo
EoBM?-o-ME-?-?-E-----??Mo?B?o---M?o-MoE-E-BB-BB-oM--E--|B-M-M?-E?oM?E--??-?-ooo-Mo-o----Mo-?--o--M--MooMoBE-TB?--o-?--B--BM?E--?-o-oM?oEB-ooB-EBoB?-M--EM--o-E-M-M---??ooo--B-B-oo--?--oM-E---EB---oEfoo
?TEMMB---B--EoM?-----MBT---Bo?o-T?----T-To-EoM--T-BET--|-E-E-o-T-TT----MT-o-oT--MMM--o----oo-oBEEoB--o-M?ETB|TEBE-TM-M-o-MB--M-M-BM--T-M-?Mo-?--M--o?MTB-M---MoMM-----MT--o-?oB-M?-BMT-M?--M?-BTo-E--foo
m|-M-----?o-Mo--ooE-EB-|-M-?Eo--|-B-EE|M|--MEEo-|oo-|o-|BMoME-M|o||EB-BE|--E-|M---?E-EEo--?EBBB?MEoo--E-BM|E||-M?-|-E-E-M?-BMEo--M-o-|-BE-M?BM--MM-MM-|?o-BooB-?-Mooo-E|oo?-??-Mo?B??|?-oBB--oo|B-B-Bfoo
XXXXXXXXXXXXXXXXXXXXXXXXXXXXXXXXXXXXXXXXXXXXXXXXXXXXXXXXXXXXXXXXXXXXXXXXXXXXXXXXXXXXXXXXXXXXXXXXXXXXXXXXXXXXXXXXXXXXXXXXXXXXXXXXXXXXXXXXXXXXXXXXXXXXXXXXXXXXXXXXXXXXXXXXXXXXXXXXXXXXXXXXXXXXXXXXXXXXXfXX
