M?E---o----EoM-----E--Mo?-oMM---Bo-----oM--MBoBBo--MoB----B-E-oo----ooE-?oMM-o-Mo-B-?o---MBE---oo???-o-M-o?-?B-BBMEBE---E-o?ooM-?EoE-BB?M--BM----B----MB??--??--B-BoMo?--M?-ooB--Eoo-?oo-o?-?---oMB-o-oo
oB?-ooo?-M-M-M-M----M-o-o-BB-MB-o--M-M-?-?M?--o---?-M-oM-o-?-o-oo-?--?-Bo-oo-o-o--MEo?Bo---B?B----o---EE-E-----E-?BBMB-?Mo---B?M-M-B----?-o-?o-?o--?-o?----?---BB--o---o?o-ME--M?B---MB--BBoB---EM-o--oo
-?---E-M-E---M-?--Bo-BM-M?EoE-M--???--?o?-?--B-------o-oBB--M--MMME----EB-M--EM--??-BE-BoM-o-E-B-B-------?-oo--Bo-----M-?---??M-?-?-BoE?E-B-BoMM-Eo-Eo----?o?---oB--BE?--oo--?E-B---B-EMM?-B??BMM-M?--oo
----o-???---?-?o--EE---EB-Bo?o-o--BEo-M--E?-B?EE-o?-?-?-B?o---E-E------?-----MM----Mo?------B?-MB-M----?--ME-?E-?-----?Bo-M---?o-BB---B-B--------BB-BM-?-BM--E?-B-B-B-?--E--o?-EB---E-M?oM----Eo--Moo-oo
-oB-??E-E--?EB---???MM-M--BEB--?--M-?-?o------?----B-E-?o---MB?---BM-M-E--M---o----?M-E-M--ME----oB-?oo-----B-B--B-----oEM-oB-?-----?MM-EoEM-?---o--EoEBo--o-ME---M?--Bo--M-o-MB--??B-M-B-oEo-B?-E--B-oo
-?BE-E??M-o-?B-E--MM-M---o-M-oM--EEMo----B---B--M-MB----?B?B-?Eo?BBo--E-B----BBoMBo-M--EB--E-o-B----M-o----BMB-EM----oBoM-E?-BM-E-MoM---?EBB?---B-BB----oB----MB--o-MBB---???EM--B-B-----MB---B--B----oo
--o?-??--BoM--MBo--??M-ooB-o?M-EM??-----Eoo--B-----?--o--B-E---oEM?-EMM-----MM-MM--M-o---B---oM-o-----E--ooM?-M-M-Mo--B---?---oM?-EME-M-MM-B----MEo-------MB----?-ooE---B--oM--oM-M--?oE-?--?M--BB-EM-oo
--o?o-E--?-BMMM?o--o?-EMo?--?----oo--oM--E-?-M----MMo-----?-M-MoB--o?M-B?B------o---Moo-MM---?M--o---B-oM-M?EEM?B--o-BE-?---B--EB--MM---E-?-B--?-BB---BM-M-BEM?-----Bo---MBEoBMBoM--?oB-o--o?EE-E-B?-voo
o?--oE-BM-BB-oo-?o?-----Bo?---E-oB-Mo----M?E?B----MoM?-oB--M---B--o-?BB?oooE??----??-MB-----MoMM----?-Mo-B???--MM--M?-------B---?M-M---MBoMBMo-oB?M-o-MoE--B?-MM----EE-o--?--BoE?BME--oo-o--MB--M-?MBfoo
EE----MB---Bo-Mo-M-EE---o-oM-oMEM---oME-o-BB--oo-----MEBMoM----??M?MMBo-----B----??oMM?-?o--M--E?-o-BoBo-BB?BB?----o?Mo-?B-?-EMBo?--EEB-M--E-?oB-?B?----?Bo-?BBEo---?-o--?---?B?MBo?-M--E-E---M--?--?foo
M?B--o-o---oM-M-oM?-BM-oo?MooB?M??B-B-MBB?-MoBB--MBB-M---???-----Bo-o---oB-E---BE----?MM------M-BBM-----------?EM?-?BE--?--??-M------?E-----o-EB?-BEM?B-E--?-B----EB----Mo-?--B?E?M-----M----ME?--?o-foo
BB-??--M--?M----B--o-B-oBo--?-?-B--E-E-o----M--o?o?-ME--EB-B-?E-------o--E-M-E-----Mo-oo----EMBMEE----M--M----EBMM?-M-----M--MBoE---B---o-BB---?oo-B?-o--EM--E-Mo---o--?-?---?-?-EM-?----ME?--?BE--o-foo
M--Bo-B--oMoM?BoM--Bo--o--M---??E-?M-M---M?-MM-?-MB-?M-MB---EM?-o--o--o-?BT-M?o--?o--o-?----?oo-BBTo??---B-EE-B?oBo-?-M-?M---oM-?-EMB--E?M??-?ME-----MB--B?--MM-?oM?ooo---E--B?---MM--B-E?-BoT--BoB-ofoo
?--?---TT--oB?---MoMTE-M?-?EoT---E-?oBT-BEB----?E-B-?-o--?--B-?o-BE-ME-Mo-|MMo-oT-ooM----MTEEoMT-?|--EE---?----B-M-oT-o-BoTE---o-EBo--T-BoTToBo----ET--M-----?--M-T-MTE?MM?ME-B--oo-E-M---MoB|?To-M-Bfoo
m?M?-?E||-M??-E--o--|MM-?BB-M|MM??---B|oMB-?-?EEB-BM-Mo?-MoB--BM---oBB--E-|-EMM-|BB--?-o-E|?-E-|oE|-EMM--EB-MM--E?E-|-E-oE|Mo---E?M-MM|-E-||EE-BME??|-oo--M-MMB-Mo|-B|?E-oB??ME-B-BE-oE-EB-M-|B|M-Moofoo
XXXXXXXXXXXXXXXXXXXXXXXXXXXXXXXXXXXXXXXXXXXXXXXXXXXXXXXXXXXXXXXXXXXXXXXXXXXXXXXXXXXXXXXXXXXXXXXXXXXXXXXXXXXXXXXXXXXXXXXXXXXXXXXXXXXXXXXXXXXXXXXXXXXXXXXXXXXXXXXXXXXXXXXXXXXXXXXXXXXXXXXXXXXXXXXXXXXXXfXX
