--------------------------------------------------------------------------------------------------------------------------------------------------------------------------------------------------------
--------------------------------------------------------------------------------------------------------------------------------------------------------------------------------------------------------
--------------------------------------------------------------------------------------------------------------------------------------------------------------------------------------------------------
--------------------------------------------------------------------------------------------------------------------------------------------------------------------------------------------------------
--------------------------------------------------------------------------------------------------------------------------------------------------------------------------------------------------------
------X----------------------X-----------------------------------------------------------------------------------------------------------T---------------------------o----------------------------------
------XX--------------------XX-----------------------------------------------------------------------------------------------------------|--------------------------------------------------------------
------XXX------------------XXX-----------------------------------------------------------------------------------------------------------|-------------------------------------------------------------v
------XXXX----------------XXXX-----------------------------------------------------------------------------------------------------------|------------------?????--------------------------------------f
------XXXXX--o-----------XXXXX--------------------------------------------------------------------------------------------o--------------|-------------------------------------------------------------f
------XXXXXX------------XXXXXX-----------------------------------------------------------------------------------------------------------|-------------------------------------------------------------f
------XXXXXXX----------XXXXXXX-----------------------------------------------------------------------------------------------------------|-------------------------------------------------------------f
----X-XXXXXXXX--------XXXXXXXX-----------------------------------------------------------------------------------------------------------|-------------------------------------------------------------f
----XXXXXXXXXXX------XXXXXXXXX-----------------------------------------------------------------------------------------------------------|-------------------------------------------------------------f
m---XXXXXXXXXXXX----XXXXXXXXXX-----------------------------------------------------------------------------------------------------------|-------------------------------------------------------------X
XXXXXXXXXXXXXXXXXXXXXXXXXXXXXXXXXXXXXXXXXXX--XXXXXXXXXXXXXXXXXXXXXXXXXXXXXXXXXXXXXXXXXXXXXXXXXXXXXXXXXXXXXXXXXXXXXXXXXXXXXXXXXXXXXXXXXXXX|XXXXXXXXXXXXXXXXXXXXXXXXXXXXXXXXXXXXXXXXXXXXXXXXXXXXXXXXXXXXXX
