-M?-M-oM--o-MoBBo-E-o-M--BB-o----oEBo---?-?M---E--Bo--?-Bo?---oE-B--?-?M?--BooB-oM-E-BB-??MooM?M--------o?o??E-Mooo-oo--o-?MoM--?ooB-o--?o----Bo-Eo-o-o-B--oM?-M--?--M-oo------M?---?o--B-EEo-----BM--MB
----Bo-?-o?M-BEBM?BBo--?o-M-BM--??--?-ME-oEB-o----EM--MBMMoo?BM?M--E---BM-----BB-BEM-------M?--M-B--o-EoMB-----MEM--EM-?M---?--o??--o-B?---BMB-MBM---B?---------M--o--oo----M-o--oo-oM----B?M---?-?--?-B
-MBMM-M-oMBE--M-M-o?oM-??MEB-?Mo?--B-o-?BoB--B-B-oBE--MB--E-?BM--oBMoMo--ME--M?BM?M-BE-o-MEME-o-----M----BM-o?MMMBE?-?------B---o-M------o---B-oM?M-B-o-?oB-o--?-o?--MB--Mo-M----B-?-Bo--MoM-oE----o???M
M?-?-BB-ME---B------?-----?Bo?--Eo--E--oBo-B------B-oE-M---E---?-----?----MMMoE?--o-E?-----M?oM?----MBB--BEo--M-B-M-B-MoM--o?--E-M?--oM-B-MBB--MEEo-?BM-E----B--B--M?-?-B-MM--oo-?BEM-M--B--?-M------oE-
ME-?o-Eo--M--M-----oBEMo-M?-M-MoMB-EB-E-------ooMBM--B--?B?---B-?-B-E--o---o---?Eo-MM-?-?o-MM?-----M-oM--B-E---BB-oE---EB----BoBMoo-?-oo-E---????--E--?---o-?BM?EM---E-o--MB-oE-B?o-M?--o----Mo?-?B--B?-
MBMo?B--M-o---o--?-?--E--o--?EE---oM?M--oM-MB-ME?Mo-M-E--M-B-?o-Eooo-MMM-o-M--BE-Mo-M-ooo-MB----E------EE?-B-??--oEMo--Mo------B--?E--M--B---?-----?--E-oM--BEo-?--E-M-?BMM-??BM?-Mo-BoBM-??M--o-B-oE?-B
-EoMM-o-M-E-oMB-BB-M?B--?M?Bo?M--M---E--B-M--E--B----oMoM-BMM-EB--o-BEoMo------BMoBE--MB?--ooBoB-EM--?-B----M---B--?--E?--o-o-ooEE-ME?-B-M-----E-o?--E----M-BB?E-E?M-Bo?-MoMoo-------E-o?BMoMEBo--M--Bo-
EB--?--M--MoB-MM-E----oM?-E-B?o-BEMo?MM?-B---B-B-o--oB--??B-o--B--Mo---oBM--?-M??--MME-B--??--E?-B-M?-o---?-----???oB-B--B?Bo-E-----?-o?-?--BM----B-?-B-B---??MM--B--MM----BBB--B---M?oE-M???--?----??-v
Bo--?-B-------B--?-BB---o--MEo-M---o-EoM--EM---EoME?M-?oo-B-M-o--M?BB?-----Eo-B--M-o-B---?oo--?----MM-E?oB-Eo-o-Bo?---E--MMoMB?EMoBM---M-oBB-E?-B--oo??oM--B---?M?--o--B-?------M-BBMooMo-?-M-MoEM?-?---
-BE?-E--o-?EBE---oM--?--?E?-?-?B-B?EB?-o--M?----B??B?B-MBo-?B???E--E-?-B----?-----M--o---BEo--EMo-o--oB----B-M--EM?-?B?B-o----?B--E-MEBo-M?o--o?--oooE--M----o--Mo?------?-Eo-M--oB?--?-B--BBEBM-o-MM-Eo
??-oM?----?--M--E---?-o?----M----o-MB-?-----B-o-??M----E-oo-B-B-?---EoMo-?-oo?Eo-E-EBM--M-MB-----E----?---?o-o---E-o-oMB--?-M---?-?-o----B--o---M?--M--E--EBMo--o-MM?-o-BME?-Eo?--o-?---M---E-o--B----?-
-------?--B?-----Mo-??--?M-B?o-M----B-M-B------B-o?----BEM-ooM-EM---Moo---BEEBBM--oB------M????--?-----?-E?-M?M--BoM-Bo-?-E-E?E--o-M-BE--B-?-------EM-?--o?M?-M?------?-?oME---o--BMM?---oo?M?B-----Mo-o
BE---?B-EBB------EMB-oMo?---?----?EM-?oBBoo--oBB-o-T-ToB-MEo?----oE-TE---B-MMB--o-EE-E?-MM?BMB----BBBEMM??-?--TE-B?M-Mo??-BE?B?-----?M?---------?-B-oB--B-?oTEMM-MBM?E-o---M----B--E-B--M-?Eo-------o-o-
BBB-E---?---B-----?M-MMoMo--M-----B--?-E--E?-BB-oMM|?|?oM--MET-T--T-|??oT-?-?TM-?-M-----?Bo-M-MMTE--o-o-TM-oTo|TB-M--?M-B--B-E--E-TEM?-TBE--?MMT--BBTo--o?-M|-??o-?----T-oTBMoM?ME-T?o-oM--T-?---oE--oT-
mM?E-?----EBM?oo-BBMB--BM?EBE-o?-B--oBM----BoBo?oM?|-|?BB-o??|o|E?|E|-E?|o-o?|??oB-E?-oEE--M-?--|MEMM-Bo|BEE|E||?--?--M-oE?--BM-M-|-E?B|?----B?|-B--|-MBoBE-|M??-MMo-?-|M-|-oM-oo?o|oB-M---|-Bo-M--M-M|-
XXXXXXXXXXXXXXXXXXXXXXXXXXXXXXXXXXXXXXXXXXXXXXXXXXXXXXXXXXXXXXXXXXXXXXXXXXXXXXXXXXXXXXXXXXXXXXXXXXXXXXXXXXXXXXXXXXXXXXXXXXXXXXXXXXXXXXXXXXXXXXXXXXXXXXXXXXXXXXXXXXXXXXXXXXXXXXXXXXXXXXXXXXXXXXXXXXXXXXXX
