B-oE---oM-oM--M?-o-M-Bo----EE--B?o-?--B?o----oEB-??oB--M--BB---o-?-B--BM?Eo?-??--M--M---MM?EBoo---E-------?-M-?ME?---MoMBoM-BM-B?EM-??B--M-M-oo?-M?-MMB--ME--B--oM-oEE---M?EB-M-M-oE??-----M?o---BooM-oo
-o-?oB?B?o-ooM-BE--B-?oMo--MMo?-M-E-?E?MoE-MB---B---o-EoM-o-EE-Bo?----o-M??ooM-----o-E----B?MoB-M--o---?-BBE?-E-BB-o?M-?-o-?--o-B-M-M?-o---???----------BEB-B--o-MMBMMEB----------?---oM-o?-M-o-o-o-M-oo
-?-?M--BBB-M-o-???---M--?M-MEM-?M?-oBB-M-?-----B--oBBB-Bo?EMMM-M-?-ooo-oo-B-M--M--M-----BBBBM-BoBMM-?M-B---Mo-MM-oM---B??B?M?-?--E?-?o--oE--M--o-MEooB-EBM-?---?o-oB?-??E--oBB?--?-M-B-B--E-M---MBM---oo
-o-?----oE------o--o-B-----M?E-----?---o---E-----M-o---B--MM-B--?----?E-----o-ooMBMM--EE-M--?-E-B-ME-EBoE-oMo--?B?-----ME?--E-MM-?--E--M-B--?-----?o-----B-??M--EB--BM-EM----MBEoB---BEo?MB-MEo?oE----oo
--?oB-o--?M----M-BBoo----------?o?-B--E-B----?Bo-M-oo--o-B?B---E---M-BBB-??B---?-??--MM?M-M-M??----?---M--?B-o-o------E-B--MM-Mo-oM-B?M?M-M---?--oB--Bo-E-B----MBB?--EoMB--B?-o-oEB-BBBo--B-??--BBoBB-oo
o-?oo-??-o?-E?--BMBB--o-o-M?-?EM-B-oo-----?oB---o----??-Bo--MEMM-Bo--oB-o?o-o?oM-M-BB-oB-BMEM-EEEME?-B-o-oB-o?----o---?B?-o-oB?BM-o-o----BM-M-EB-ooM-M-BBB--E----?M-MM---o------MB--o-B---B-ME??MM--M-oo
?-oEE-EMM-M--E-o-?--o-M-?-B-M-----MBM--MM--BooM?M?--oEo--BM-o---??-E--BEo-E--Mo-----M--oo-oM--?M--Bo---M--M-?-o-M?--o-?---BoE-?-------o---?-M--M--Bo-?BM-B-B?--M-MB-o?---Eo-?--------?-o-oB-B--o--M-?-oo
B--B?B--M?--M?-?M-BMo-oB?---?Bo-o---Mooo--o--ooB?-M--Mo-?-M-M-M--?-M--BM?--BoB-----ooM-M-E--?MM-M----B---oB--o---M-B--EMB?-o-B-o-EBoB-M?--B-oMEoo--BoB-----B?--?-oBB-MM?-?--o-o--o-M-?M---M-M-?M-?o--voo
---o--E-E---MBEB----MM?------o-?--Eo?---?o-o?-??---o---E-EE--B-oo-Eo---EBM?-MEBMB-?MoB--BB?-B---oBoB----E-EMM--?--B-B?--?----oEMEB---BEE--M--B?--?-E---oB-Mo?--o--M------EM--oB--------M--E--o--??---foo
BoB?EB-B-o?M-MBMM--BM-Mo--E---?B-EMo?o?E-?-o?--M-?-o???-?M??--M----o?M-?-BMMMB-?M---M-?--o-o--BM?--?E-MEM-B-o-MBoE-M-?---M-o-BB-?B?-E--BB--BM-E??-M-M-MEMM-?M?o------E----MM-o---?-?-----o-----E-E?-Efoo
---B---?EBB?M-o-oE--o-M---MMo-Bo?--------ME--o--BM---E??B--Mo--ooo-BE?-E-----B--E----E-B-o?B-BM-MM?EM-B--o----o--BE-E--oMMBBB-M-?----M??-o--B-M-E--BB--?-oM?--?----BoMME---?-?oEMBM??-?--ooE?oo-----Mfoo
B-M-ME---E-o-----?-MB-B?M--Moo????----oMo-?-MM-ooMBM-Mo--EBE---M-B-o-B?M---BBM?o?-B--MoM-B-?-o-Boo-B-M?---BM?MM-B--o-BBo-BMo---o-BBEM---o-??oMB-?--------MB--?-BoE-o-B-MEM?-BMEB-E---EB?-BMBMoEBooE?Efoo
oB---BM-ET-B-?-?-MB-?B--M--o---MB-----oB?-oEMB--o-?---BB-?-B-o--??--M?Mo-?-E-?-o-o---ME-o?E-M-M?o--T-----M??---M---M?M-B?BB-B-------E??T---E-M---oo-o-B--BMBEBoE?BB---?-MM?-?BT-o?B?MMM--Mo--o?---BBBfoo
o-M---T-?|-TEB-M-T--B-o-T----M-ET--o-BE---BM--o?-T--E--??oTBB-TMMTBo-?--oo---?-EBMEE-B--o---E-B-B-B|ooo------oTo--??T-EMBT--E-To-TTTT-M|TMEMB?-ooBM--?-TBoTMT--MBT--E-T-?o--o-|----?o---M-B--M-ooM---foo
m---??|oM|o|-MM-o|-EE?-E|M---oBM|---?oMo?BEoo-EE-|-oBE?EEo|MM-|?E|o?----o-M--B-?BoBB-E-M-?BoME-EEEB|EB--?BMBMB|-EBMo|o-M-|B-M-|-E||||oB||E-o-Mo?B--BEB?|-M|-|Eo?M|E??-|BE-o---|MMEBBM-?BM-?--?E---E--foo
XXXXXXXXXXXXXXXXXXXXXXXXXXXXXXXXXXXXXXXXXXXXXXXXXXXXXXXXXXXXXXXXXXXXXXXXXXXXXXXXXXXXXXXXXXXXXXXXXXXXXXXXXXXXXXXXXXXXXXXXXXXXXXXXXXXXXXXXXXXXXXXXXXXXXXXXXXXXXXXXXXXXXXXXXXXXXXXXXXXXXXXXXXXXXXXXXXXXXfXX
