E-EM?o-MB-M?---o-?-o---BooM-E-B--oEoB-o-o-oE-B---Eo?-M--BBB--?-?-----o-B-EB-BMo-?--B-?M----?--??M--MEMBo-?M-BB?BM---Bo?B?o-o-MMEM-M-oo---B-o?BM-o---o??---M-?BoMBoE-E-B-?MMEB?--BB-M--E?B--?BBo---o-?-oo
M--o---Mo--BEo-ME??---E??B--ME-B?---oM-MoM-?oo-E--E??-B--Mo-o-------MEBBMBBoEM---M----------Eo-M-o?E??-o?M?---M??-B-B-oMMEB?BBo-ooB-??MB---M-oMBMM-------M-o-----MM-BM?Eo-B--BB--E--?o-M-oooBME?o??-?-oo
B--?B--?---?M?-?M?---??-??----?-?M?M-Mo-M-BE?-?--MBBo-o??M-MMEM---MB-?MooB??MMoBoB---E--M?M?--?-oM?BB---MBo--M?-M-----??o?-?o?-----ooM--???ME--ME-MoEMo-M??o-EEM-------?-BBM-B-E-Moo-------M?oMBB-EEB-oo
BM--B-B??-B--oE?-B?ooo-oEEo-?-M?B-M---B--o--E-?---M?-oB----o-B-o-MoE-?o--??---E?--M-?MoMMM?-E-BM?-M-o?o?-----oM--?Eo?o-----BBo-M?---B-o?-B-?--M--M?---?-M?---?MM-o-----BMEoM-oB?MBM--M-?-oo?---o-B?B--oo
M?--?BMo--o-o----MMoE-?-M??-------M-------?-------?--E-BoM-?o-oo-oM---ooo-?o?---M--BoE-----E?-B?EB----oB?o??--MEo?oE---Mo-???---M-?-MoM-?o-B--B-B-B-o?-M--oB-?---?M?M??--?-M?oM-BB----?M?----E?-?--M--oo
Bo--???-M-MM--?BE-B??BMB?-M-?-?-Eo?Mo?--o-BBMoMEE-B-o---?EM-M--E-?--o?-?-MBMBM?-BM-BBM--Mo?-?M----M-B-MB--B---M--Bo--?--MM---EB-B------BM--oMo?M--??o---??B--oBM--BBE--M-Mo?-ooo---o-M-?-Mo-o--M?-oE--oo
oo?-?o--M-E--M-EM-?ooB--E-B---oo-E?-E-??Boo-MoM-M-M?---o?-o-M------?---?-E-MM--o-oE-o-------oBM?--?-oB-BE-oMEEBM??o?-??M-MEoB-o-oMoBo-?-?B-B???-oB--MBo--oBE-ME---M-M-o-???-MoBoo-o-B------?-o-B--B---oo
-B?E-B-Bo?--MB-B-oE-?o--Mo?o-B--EM-EME----o-M?B-Bo-B-?M-------BoBMEEMo--o-----M-B-?--Bo?--M-oE-BB-?-B--o??-B-MoooE?E--o---??-B--o--??--?-M?oEoMEM?-E-E-Eo--?--?-E-oB-oMMBo?EM?BooBB-EEM?MM-EE-M?B-MoBvoo
-B---MM--?M--E-B--B-?ooEMM--o-Bo-----M--oEo?M-oB-oo--ooM?o--Mo-B-o-MB--?---EM??ME-o-oEEoB-?-??ooMoEBBMM-B-B---M--?-?B--M-?E----BoEo-o?o-o-B??-EB---M--MBMo-Bo--o--oM-?-MMBM?B-Mo?-o--M?-M?-M?oB--?B--foo
-MB?--B-B-----M-B?--ooEMoMo-?MBMMMB---Bo?-?-?-?o-o--o?o--?-E?--oE-o---oE--M-B-?o?M-BM?M?-o-o-ooM?MBBE-E?Eo?-Eo---M-M-E--o?B-?-oB---BBB----?-B-M-M-----B---o----EM-?--BMEB--?M?MBB?B?o-oE-?-o-----EEMEfoo
---M-M?E-MEMB--B-?-EE---o??---BM-o-o----o?E-oo?M-B--Bo-MoM?B----o-B???-oBM?EB?-B-oM?---oBo-M-M-oBB-o?M?B-BM-?E-BM?EMM?ooM-o?-?EB-ooME-oM?o---E?-?o-?---EM-oo--oMB---?---BEMBBoEE?-BBBM--M-EoooE-BMBE?foo
o-o?-MB-BoM---?---oBMoE-o?-?o-Mo?----oEoEoME----?M----oM?-MB--E---EE-Mo?-M-M--BB-??oMoo-oM-E?M?E--?----EBBE-----B-?--?-?E-EM---MMM-?B?-B-?-B------oBoMB--B-Boo---oMo----EB-?MMB-B-?MBo-E-M-o--Bo-M--Efoo
Bo----oB?MM-E?----o??BMB?---?-??--EM-BB---E-M-o-?-oM---oo-EE-BMo-M--o------M----B?BM-M-M-??-?o?-ooBooo-B--?M-M?-?--MB-MoM-Bo-o?---?oBMB?----?-BMM-?MM-----BE---B-oEMMBo---EoM--o--?-B-o-o---?-B?M-?--foo
-ooMTo-B-----o-??-M?-MBB--MoBMBBE-?------T?-?E---??-?MooT-B--BTT--MMT?-E-T--M-M--oM?o---M-M----MM----oo?-E?o---oM-o?ooTE?-BoEBTT--oM?oBoTo?BB-o?---M-?M--o-T----o?M-oT----?--M?ET--o?----To--B-?MMToTfoo
mBB-|-o-E-M-BMMBEoB---o-M-?MBE??B-EoBoo?-|B------EEBoM-B|ooo-M||-?oM|E---|--EB----o-o--oM?B-BM-o?oo-?BMBEBoo-E-M?oo---|B-??Boo||-?EM?MoB|?o-E?MM-oEM--M?--B|EM-?-BBEM|oBM--?-EM-|oo-EMo-E|?M?EoBEM|o|foo
XXXXXXXXXXXXXXXXXXXXXXXXXXXXXXXXXXXXXXXXXXX-----XXXXXXXXXXXXXXXXXXXXXXXXXXXXXX----XXXXXXXXXXXXXXXXXXXXXXXXXXXXXXXXXXXXXXXXXXXXXXXXXXXXXXXXXXXXXXXXXXXXXXXXXXXXXXXXXXXXXXXXXXXXXXXXXXXXXXXXXXXXXXXXXXXfXX
