M--E-?--?---Eo-BM-MoM--o-B?--?-BMB?MBM?oo??o--BM--M--E-----M-B-o---M--oo?----M--B-?o-BMBo-BBM--?M--B-?M---E---BMBB--o-o--BE-oMBEB-EE----EMoM-M-E--oB--?M--oM-M--ME?---?M-?---o?---B-----?--E--?---M-B---
--o---?-o-B?-------?---M--BM---BB-Bo-?-B?M-o?MBB----??BM?oE-oo?oo--oB--?-MEM-MB-BoBM?---o-o-EM--BM---oB----M--M-B?-B-E-B---Mo-BMMo---B--B?-MBoM--?M-----MB-Bo--BoB-EB-o?o--?--B--?-B?-B--?-?E--?--BB?-oB
---o-?-EoE-?-oB-B-BBB-BBoB?M----M?E-M---?-o?-EM---BE-?oo-M?-EBMoo--EBo-o-------BoE----o--M--B-BoEBB-M-?o-----oE--MMBM----B-oMMMMM--B?o---ooB-?----o--oo--o-----o---M-oE--?E-E--BE--BoME-ooE-?----MoMEB--
----BoMB---Eo-----BBoo----M--B--?---o-E?oB---M---BE-?oo-----MM-oB-?-Bo---?-o--M?-?-BoB--M-B-----?Mo-M?------o-BE-E--BM--BMBMBBoo----o-M--?--E-E----?--M-B----M--o--?EM--Eo-o?---BMBBB-B---?ME-oB---?--oB
?o-o--B---E?-?--E-o??--B-M---Bo--oE--E---BE-o---oBBB--B-oBoB------B-?EEo--Mo-MB?--?----M-MoM-----B-oEo-?----B--Mo-?B-M-?oEM?-B?BoM-MBBBoE---B-?---o-?-BMo-BMoo-o?o-?---?MBMo?Eo---?------BEBB-?--------E
-M---oM-E-M--o--M--MEB?EE????BB-o-?--?B------EE???B--???--BM?--E--?E--?---BE?-?oMB?--?B---M?-?B---o-?-B--M--?o--?---??-oM-?B--oM-M-o-?MM?MMB?-BM?---?-B--EooM--o-?MB-M--o--o?-o-M-E--oo-BB?-??-----??---
B-B??--MME---o-M--EM-o-?Bo--o-o?-----oM--oB-o-B-?-BMBEo---??--oM---?B--?---M--B-?-?---o--o?---B?oMEM--?--?o--M-MEo---BMB---M--B-MM--MoBB---oo--MME-o-M-MBB?BB-BEBMB-o-BB--?---o??-MB--?M---?-MEoM-E-E-E-
-oo--EMMEM-MMM--M---o-MM?B-B--E-??-Bo?-EB-BM-?-M--MM-M-oo--o-oo--??B--B-M---E?M-?--MM--ooo?M----E-?-BoB-??M?M-B-B--?B---EB?-oMM----E-E--B???---?M--o-----Eo-?Mo--o??-oo-?-Mo-M--oB-?EEBo-MEB?BBB-M-----v
--?-M----MMo--B--Mo---B----M--?-M?oEM-M?B-?B?-B-Bo-EB---o-?--EM---o-??o-MB--?-B--???-oo---?M-BM---MM---?-oBo-E-o-o??-EMB?--o?ooM--?---M?B-o--?--?M?Mo?--?--?--B-o-------B-MBooBBo-EM?--Mo---EM-?E-B---M-
o?B--?o-----?--BB--E---oMB-MMo-EoB-??EB?E-BM-----M-?EB---BE-E-BoB------?--oB?oMEBoo?---E-M-o-M?---o--MME-M?----B-o---M----B--ooo-E--o-?B-?--oB-oo-M?M--BM---?-?--ME---EBM---M-M?o-M-Mo---B--?-??------Eo
oMo-M?-o-?-Mo-M-?-E--?--M--?-oB?o----?E?BBo-M-?--o--M-M--------oB-?ooM-----M-M??-----?---M--B-?M-B?-oo------MoB----?M-M-?M-?-EBEoM--??MM-M?--M---o?--?--o?o-Eo-BEMM--M--B-E-MM--MEM-?-ME----oE--o--BB---
oM--o?--M-----?-M---B?-o?E-?E-E-?M--EoMM?MBE?-B?---o--E--M---??oM-?-?oB---?-o---MMB----oM?-o?------EE-oM-?Mo--oMoEEo-M-B--ME---MMM-M---o--M???-oo-MB-BMBM--??oB-?BoE?M-BoB--?oMoEM-o---Bo-----o--------M
Mo-MT?o---M---o-M---??B-MBoE?-BE-?-BM---EE-------M-o--?oE----o-MTB?o?-ooB-B-M-oM-T-MM---M?-E?MMo-?B---o-Eo-oBMo--BMB-----E---M---o?-oo-?---E--?-M--o-o-M-------B-E-M?o?BMM--o?---o-M?-?-T--B-?ME-?---o??
oTo-|--T-?---E-E---?o--EM-B?----o-oB-o-MTB?-E--o-BMM-T---BEo-Mo-|---?-MMM-?---T--|o-B--oo----??B--BMBo?-BTM---T---Eo-ToB-B--o?MM-T--M--T---M---T-T??-M?-To-EEoE-oBT?M-E-M-T-MTEo?-o----?|-?--M--BBoo-MTo
m|MM|--|E---oB-B--EBoo--BBBM-BE?oE-?-E-o|M-?M-?EM?M-o|-MMB?-EMoE|o-E--M--M?-?-|oE|-MM-BBoM?--B--?o?M---Bo|--Eo|oo-?M-|E---BM?oMM-|?oBo-|M-??M-M|o|MMEB--|E?-BE?---|?o----E|M?|?---MB----|--M--?EoMM-MM|B
XXXXXXXXXXXXXXXXXXXXXXXXXXXXXXXXXXXXXXXXXXXXXXXXXXXXXXXXXXXXXXXXXXXXXXXXXXXXXXXXXXXXXXXXXXXXXXXXXXXXXXXXXXXXXXXXXXXXXXXXXXXXXXXXXXXXXXXXXXXXXXXXXXXXXXXXXXXXXXXXXXXXXXXXXXXXXXXXXXXXXXXXXXXXXXXXXXXXXXXX
