-----------------------------------------------------------------------------------------------------------------------------------------------------------------------------------------o--------------
--------------------------------------------------------------------------------------------------------------------------------------------------------------------------------------------------------
-------------------------------------------------------------------------------------------------------------------------------------------------------XXXX---------------------------------------------
--------------------------------------------------------------------------------------------------------------------------------------------------------------------------------------------------------
--------------------------------------------------------------------------------------------------------------------------------------------------------------------------------------o-----------------
----------------------------------------------------------------------------------------------------------------------------------------------------------------------------------------------------T---
-------------------X-------M----------------------------T-------------------------------------------------------------------------------------------------------------------------------------------|---
-------------------XX-o---------X-----------------------|-------------------------------------------------------------------------------------------------------------------------------------------|--v
-------------------XXX----------XX----------------------|---------------------------------------------------------------------------------X---------------------------------------------------------|--f
-------------------XXXX---------XXX------T--------------|---------------------------------------------------------------------------------XX----------------------------------------T---------------|--f
-------------------XXXXX--------XXXX-----|--------------|---------------------------------------------------------------------------------XXX---------------------------------------|---------o-----|--f
-------------------XXXXXX-------XXXXX----|--------------|---------------------------------------------------------------------------------XXXX--------------------------------------|???------------|--f
-------------------XXXXXXX------XXXXXX---|--------------|---------------------------------------------------------------------------------XXXXX-----------T---------------X---------|---------------|o-f
-----T-------------XXXXXXXX-----XXXXXXX--|-T------------|---------------------------------------------------------------------------------XXXXXX----------|--------------XX---------|---------------|--f
m--E-|----------E--XXXXXXXXX--E-XXXXXXXX-|-|------------|--------------E------------------------------------------------------------------XXXXXXX---------|-------------XXX--E------|----------E----|--X
XXXXX|XXXXXXXXXXXXXXXXXXXXXXXXXXXXXXXXXXX|X|XXXXXXXXXXXX|XXXXXXXXXX-XoXXXXXXXXXXXXXXXXXXXXXXXXXXXXXXXXXXXXXXXXXXXXXXXXXXXXXXXXXXXXXXXXXXXXXXXXXXXX--X----X|XXXXXXXXXXXXXXXXXXXXXXXXX|XXXXXXXXXXXXXXX|XXX
