--o?---M-o-o----?------------B-MM?-MBEM--oM---?-?E--o-M??-M-M----E?---BMM-ooE-M?--o-E?M------M-BB-?M-?--M-M?EMo?---M---?----Bo----MB-?-oo-oBo--?oM--MBoMoM-BoM-ooEE-B-o-B?-?o-----B?Bo-?M---?B??o-MB--oo
oo--MMM--ME----MM-M-M?-o?---B-E-?MMMMBM-o-M--M?E??---B-???BM-----M-BB-?E--ooM-Bo--EB-----M---M--?B?-o-oE-o--M-M----BEo--?Eo-B-B-o-?-o-MMo---B-B?B-?-E--M--o---M--B???-?Mooo-B---oM----?-B--BE-?E-E-M--oo
oB--M?B-?--E----MMM-?--o-B---oMo?-?-E----BE---E-MEo-o?---?--?MB-oM---M?MB?oM?--M-BB--B-B---oMBB-M-?o-M---??oM-B-?-E-M?--?--M?--Bo?---o-M-B?o--o----?B-EEo---Moo---M?-?o-M-o--E-BBMM---EM-?-E-?--BM--?-oo
--?oE-E-BooBM?----M--E-B--?--E--?o------o---oMM?---oMME?Bo-E--o-o--MB?Eo??--EoMoB-MMMoo--oEE--??M?BooB---M-BB-----B-o--?oE?o--o-B??o?--EBo?---E----o-oM-oM?M--M-o-oo----?---E--?-M-oB--MB-o?o--M--o-?-oo
?-EBM----------E?--MM?-----o-M-Moo--M-o-E-?oM?-oM-E-o-M?---BMo--M-o?MBB-EM---?MBBMo--?-EoB-?--B-oM??-Bo-M-?M-BooBo--o-o--MM---oo--B??--Bo-BM-BME-B----BB--M-o-Bo?-o---oB----?----o-o-MoE?-BE-Bo-?-B-B-oo
-MB-oM----MM-o--o?--oEBB-??B?B-Eoo-o-oB---Mo-E-B-?--?-?M-MMB----B?-?oME--o?MB-o?-??-BoE-?M-EB-B-M--??-BME--M-oMM-B------B-oB--E--EM-M-oM-?-E-B-?-ooB---o--MB-E-EM?-oE--B-ooo-oo-------M?-MoB-----oEBo-oo
-MB-M--oMoMMB-EMo-?--B---MB?-Bo--?oE-?-BBM-M-MMo-M-B-BM?M?-ooB-B--M--MM-M-?-EEMoo-----B-?oo?---EM----BB--o------Eo-o-oo--M-B--M---B--B-E---ME?o-o-o-E--B-BMB-BB--?M--?B--BMB?B-o--B--?---------oM--o?-oo
-Bo---o-o?--oE?-o-oBM-??-?------?MB?o?--?EB-oMoE----EBE--M-?B?-o??-?--?BoBBM?Mo---B--E-o-?--B-oMoMMM-M-??MMM-B--B?MMB?M-o--ooM--o?-?----oE--?-------MM-?--o---M---M-oB--BB-o-MooBB-M-MM-??-B---o-?B-Bvoo
-oMBM?-B?---??-BM-M--ooo-M--o----B-o-?-ooB??---?M-o-M-ME--ME-MBMB-?-M-oEo---?---o-EM----?--?-oE------E---B-MoB--oo-?---MMMM-MM----BM---E-----o-MM---BB?-?M-?-B-?E--B---M-E-E?Eo-B---MB--M?o-M-E-B---ofoo
oo-M----o-ooB---M--B-M?--M--oM--ooE--EB-BE-BEB----B-Bo?---M----?--M--B-B-BMoMo---B--B-oB-oBB-?M-?BMM??-B-?-M---E-??Boo-?-M-B-BEM-oM--M-B?-M-B--M--oB----EB-MMBBM-??-B-?M-?B?-M--?-BBo-B?--?M----BMB--foo
oEo?BoBMEB-o---E--?B-oo---E--B-??oMB----MB-B-B-BE-o---?MBM----M--EMM---M-B-B-??B--?MM--E--BE??M-oMM-B-B?-?------BM--B----EM-----o?----MMM-M-?--o?-----------M-o-E?T---BB-B--?M----oBBoB--o--BM--ME?B-foo
-M?-B--oM-?--oMB-MM-o----------EM-----?E?---o?B--M?oB-BE-ME-o--oBBo-E-???-M-E-M-M-M---B?-MM?B-oB-?MEM----E--?-M--?-BoM---?---BoB-?-oB-ooo---B?-E--o-----?oM--?----|M???B-----B-M-??o?B-??oBBBE--?-EBMfoo
ooM--Tooo--B?MBo?---M---?--?----Mo--B-E?--B--M---B----oMM---B-BB-----E-oM?--?----o-MoBB?-BB?MM-?-?--MEB--M?--?Bo---M?o-o-o--o-B-----o----o--o---E?-----EMBEME?EoMB|B-o--o----oo---M----o?M??B--BBEBo-foo
-?BT-|-?---T-M-MM-BT--o-TM--M--BT--T-oT-?--BB-?M-?---oMBo-BMB--TE---MTBo--?--o-ToT-??Eo-M--BB--T----T-B--M-?T--T-?o?M?MMB-o--?Moo-MoTB-M-E--TT?M?B-ToM----MT---B--|---oBE?B---?-B-B--T-BM-?TM?EB-----foo
mMo|M|MBBE-|EM--BBE|??--|?ME-M-o|-M|oB|?o-E-?M-E?ooB--MBo--?M-?|Mo--o|o-B?-o?BE|M|oMB-o-B?E??E-|?EM-|Mo-?M-M|?E|oBMo?-?-EE--MB--oBBE|M?-o?-o||Bo-M-|B?E----|oB?-M-|oB-MMMMB--M?EE?o-?|BEE?-|-oMoo?---foo
XXXXXXXXXXXXXXXXXXXXXXXXXXXXXXXXXXXXXXXXXXXXXXXXXXXXXXXXXXXXXXXXXXXXXXXXXXXXXXXXXXXXXXXXXXXXXXXXXXXXXXXXXXXXXXXXXXXXXXXXXXXXXXXXXXXXXXXXXXXXXXXXXXXXXXXXXXXXXXXXXXXXXXXXXXXXXXXXXXXXXXXXXXXXXXXXXXXXXfXX
