?--B--o-oMMB?-o-?-MoB---oEMo----o-?--E--?-o--?EB?---M-E-MB---?o-EB?o-Boo-EMB---o-?M?oE-M-oB-Mo?-B-M-------M?-?oM--Bo--E---BMMM---o----?-Eo---E-?---oM---Mo--oo-?---B-B?---EBBE-E--oBo--M-----BE----o--oo
BooB--B?E-o?MB------M--??--o----?E---?-o-B-MBM--?--E-?M-o?-------B--oo?B?B--oM-BEBBE-?M-B-?--B--oB-M-BM---E---B---o-o--E-----BoB-MoE--M?BoE-o?M-?--B-?-BM---o--?----E--o-MM----MM??-Bo?M-M--B-B-?--?--oo
---EMEo-?-o--E--BM?BBo?M--o?oM--?------ME-?-M-?o--?--?-ooM-EB?-Eo----o-o-BMo--M??o-??---BM--?oo--MoMo---M-BBB-----B-?oM-?-ooMEBMB-?B---?o-?B-M--?--?--o--EMoo---M??B-B--oM--MoE?o?-o-o?-?M--ME--------oo
MMB---M-----BM?------BBoB?----Bo-M----?E--M-B?o-----?o-??E-B?o--?Mo-M?-?-B-?-M--B-----o-B---o--oEM?BB?B-o-----M?-oo-E-B-MoBMo?B---oE--Eo?-B?o-o-ooE-MM?---oEo-o---B?Bo---B--M-BMBMBM-M-?-M?-M?-o?--??-oo
MBoB--o-EM-B-BM----B-o-B--o-BE-E--EE-M-?---Bo--o---?-B------EM?B-?--oM?EEB----M-o--?MBMEM--------o?MM-M??------?-EME-EM?--oo----oM-?B---o-EEoMB--??oEo-BM??--E?--M-o--??-?E--?----?--ooM----EBMB-B----oo
B---?o-M--M--B-M--?-o?--MoEB---MoMB-?--E--o--B-o------M----------MB--?-MB?------o--M---B-o?M?EB---BM-o-oB-----MB--MB----EE---?B----B---o-?-M-----???-MM--M-o-M?-------B-oE--B------o-M?EBEBoBoE--MEB--oo
--o?-------M-BoB--?M---EM-B-o--B-M?B?------oM---o--oMB?EB-M-Bo--o--M------Moo-oM-BM?---------M-oB-M--EB?--BEBE--EM---o----?oB?M--?B--MMM-M---oB?-o---?M--MEM-?-MMM?EEEo-EMooBM-oM-??E-M?---o?-----Bo--oo
oE--o--o-B-?-MB?-B-MME----MBM--ME-o--M--B--EBoEE----MB-M-o-?E?-o--o?-EE---?----oM?-B-o-?M-----?B-?-----oB?-B??---o--?-E--M----?-Bo?--?B---Eo--BE--BMB-oB----EB--?--M-Bo-M------E---EMo-M-?M-Mo---M-oMvoo
-?o-o--?-B--M-MEooM-??o---?-?o--M----EMBMo?-M-?M?------MoooM-M---o--?---M-B-EE?--o-o-----E-o-oo--?--?M-B--o?EEoMoM--Eo??---o?----?M-E-??Eo?-M--MB----BE-oB?-?--BE?BEo-M-B?o-M-----EB-MB-EMMB----M-?-Efoo
oM-?-ooBE--M----BB--oEo--M?--ooo---o---?M?-M-E-M?ME--?-----oB---oMMB-B-?-?-MMM---Bo--B-?-MEMB-oEo-o-o--BM-o-------?-?-M---E---?B-------B-B--M??--MM---M---E-o?o-B--BM-B?-E-EM---B?-?--E-B----BM-B---?foo
-B--E-M---o?B?--oo--M---o--oMBBM--oMMB-o-oEB---MB?------M-M---MM-E-M-?E----B---M----oo-oMo-MM--B----------?--oBE?-B---B-M-?--M-----M-E---oo?MMM---o---M---B-M--M--Bo--EE-M-?--B--o-??B--B--o-B-ME-ooBfoo
o-Eo--B-o---MBM-??-?B?o-B?o-----o-BBo---B-B?o?-M-B-?E-M----B-oB?--E-MM---??EM-??---B-M?-?EBM--?--Bo--E-----E?E?-MEoEM?----BB---?--M---MooE-o-o?M?BM-?BB-o-?-o--BB--BM--M---?--o?-M-E-o-MEM-??-B--M-?ofoo
-------oo?-B-oo-?E-BE?oB-MM-----?----B--EM--E--E-?BB-Mo---B--o-?oMBE-BE--------BE-MM--B-?-------?MEM?--E?Bo--B-M??o?M--M-M-B----oMM-oMB-o-----BB---M-B--B---oo--E-o-E----MM--MM----?-----ME?o-o---oo-foo
-?M---Moo--B--MTMM-TB----B-M?MBEo?--BMM?T-TBBT-B-?--To--oB-----EM-B-o?MM?--EoEBB?-ooM--B---B-T?o-MTM---?--B-E----?T-o-T---B-----?-B---B--B---oMoT--?T-oo-MBo-T---T?----T-E?BBBM-Boo--oB-B-TTB-EMT--MTfoo
m??-E----M--oo?|---|EM-oE--MEM---EMMB-?M|-|M-|-?MBE-|EooM?--oB--M?-MM?oBooE?EB-?oE?E-oE-o-MEB|o?B-|-----E-?-M-?BMB|-?M|??oE?E---oBooM-E-?MB-B?M-|?-M|-??M-o?-|-oM|o-oB-|-Bo?-?BB-Mo--BM--E||oMM-|?E-|foo
XXXXXXXXXXXXXXXXXXXXXXXXXXXXXXXXXXXXXXXXXXXXXXXXXXXXXXXXXXXXXXXXXXXXXXXXXXXXXXXXXXXXXXXXXXXXXXXXXXXXXXXXXXXXXXXXXXXXXXXXXXXXXXXXXXXXXXXXXXXXXXXXXXXXXXXXXXXXXXXXXXXXXXXXXXXXXXXXXXXXXXXXXXXXXXXXXXXXXfXX
