--B?-oooM?ooBBoM-ooBEBo-oEoB-?o-MoM--?EMB?B-?oBB?B----o?--BoBB-?oM--o-----o--o-?o--?---B-?o??o-?-?-oBB--?-oo?-MoM-----M-M?--MB??--E?B?--?-----EM?---B?-?M-oM-MooBo?-----ooo?-EM--Bo?B-M------o--o-E??-oo
o-?o-M--Mo-B--B?--B-Mo?-oB--E--oM?BB-M--M?oo-B--oMo-MM---BoM-o-EMoo-BM--?E?B-oMEE?E------o-o-?Bo-B-o?-----o----Mo-EM-?B?o?--B-o?M-?--Mo-?o-?-MMM-MoB?BM?EM?oM--?----B-?BooBBEMMB?o-B--oBoEoMEo---B-o?-oo
B-?M-?---B?----o-B?B?o-----B--B--E--oo-?--?-?-Mo-M-MBoo????M?B-?MB-??M-?M?----oB??BE---oBoE-oE?--B-B?M--?oooME--o-MoME----BB-?M-??-B--B??oBoMo--Eo??o?--BBBo?o--?o-?o---E-?oBM-oM--o??M?----MMoBM-o?--oo
---?--M--M?Bo?BoEE?--B--?----o-B-B--B??E-?oEE??--?M-o?-o---B-?B?Bo?MM-?BEMB--E-M?MM?---?-????B--MBo-M?-B--?o-M-?B-o-oB?B?---oMM----?BBB-?MM-o-oo-o-?oo?--BBo-o-?o-M?-??-M?oE-E-oE-BBEB-oMEM--o-o---?o-oo
??ooBBM?-o----?-M-?BMM?-ME---MB-B-M---?BB--oMB?M-ooo-?M-E-oooMBoo?B-BMB-Mo----MM?oM?-----MoEB?oo??-o?-?MoMo?MB--MM-?--MM-B-M?--o---o-?---B-o-oBo--?-o---o?-?--Moo-?-?-EB?E???M--?-oo----M?-B-?--?o-oo-oo
--?oM?--oMo---?---?B-?o?-?BoBB--oEM-----B--M?E-E-oE-??--?-?-B?-Mo-E?E-B-?Bo??M--EM--EEB--o?MB-???-o-B---Mo---B-Mo-E?o-MBoo?M---?-B---M---o?---BB-oMBo--BEEoBoB-EBo--oB----M-?-?-oB-M-E?oE-M-?o--EE--?-oo
--MB-o-?B?Mo?-MBMBoo----ooBo--o-?----ME-EoEMB?--BB--?M-B--M?-B--o-MB?o-B---o-B--?-EB--Bo?-B-oE?-?-oEoo-oBBo-M?-M-?oMM?B?oo--o?o-o?-?MM--oM---?-oo---oo??B-o-??-?o-B-E?BooM-?o?MB-EoMM--M-BM?-M?--B-MM-oo
-??-?-BM-B-?B----??B?E?o?-BB-E-?-oB-Bo?B?-MMo-M-MoE-B-B-?B-M?M?-oMoo-M-?EEE-?-----M-o-BoMo--B??o-B-ME--?B-M---oo-MB---MBo-?--?oo-oE-MM?o--?--B-B-oM?o-oM-oMEBB-B-Bo?Mo-B?-?---B-MM-o-----M--B?---o-B-voo
o-Mo--E-oMMEo-oBooo--B?-o?-?-B-BM?--o--M-?o-ME-??BM--?M--o?o--B?oE-B-Bo?-BB-?MBoB-B---E--???Mo-EMBM?------?-Eo-ooEBo-o-o--oEoM---EB----B-M-B---?EMoo-?---M-?o-?-o-?BB??-?----MoMooM?-MoB-??--?---E-BBfoo
?--M-M-EoB?M--??BE-E-?B-?o---o----MMo-?--?o-oMMEo--?o-oE-o-?E?-o-oE-oB?----B-M-B-B----M?---ooo-BM--E--?--?M??Bo?o?oBEo--o?-?Eo-oM?oB--o--BM-BMBo-?---oMo?B--M?-oE-o---EB--B--??Mo-o-EBBBoMB-Eo-B-M-Mofoo
-E--?-oM-?B--M-Bo?-?M?-?---M-B-M-oEB-?Mo-E-EM-M?--oB-M?-o--B?o?EoBMo-?B-------?o-M-EB?--?oB?B-o?--BM?-o?-B-M-?--o--o-BME?ooMM?-oo?Mo?Moo-Eoo-BM-??oB?B-B?o--?oo??-Moo?----?-o-M??-o--M---B-o??-M?-M-Efoo
o??E--oM--?-M-----o-ooB-MB--?-MoBoBB?BM?-?-??---oMEo-Mo?-?Bo--o--o--Mo?-oM---o--?oE?-?---?o--o?o-o-?BoM--oM-oEB-B-------?o-o--??-EBB-?-B?-oMB-----o-?-o-o-MoM--Boo--?M?---B-oo---o?E-oE-o?Mo-MooE-MEBfoo
oMoooM-MMEo-?-E--?-MMoE-?BB--BEo--B-M-oo-MM-?----oMo---oo-BoB--???o-E---oM?EBo--BEB--E--o-BB-M----MB-B?MM------B-o?oo??-B--?o?---B-M?--?EEB?E-o-EM-BBE?M?--Bo-EoE-oo--E-o-E-??o----M-MBM?-o---M-?-o-ofoo
M-----o?-M-o?M-oo--ME-o-E--Mo--o-B?M-oE---o-?-?M--o-o-?-B-----B--?BE--?--????o---?-?M?BE?--M?-??M-oM-----M--?M-E--E---?-?o---?-E-B-B---EM----MM?MoBB-B--o?EBE-?-?o-E-----E?E-B?EEE?-?oE----Eo-?--MoM-foo
m----------------------------------------------------------------------------------------------------------------------------------------------------------------------------------------------------foo
X----------------------------------------------------------------------------------------------------------------------------------------------------------------------------------------------------fXX
