oMoB??MB----oB-ME?-MMB??-oo?-?oo?M?M-oB?--B--o-??B----M-BBMMoo-Bo?--?---o--o-o???o?-??o?---------???-o--o--o-?--o??--?-o-o?--o---??-oMooE?oBBM-oBoBo-Bo-o??---?o?-Bo-??oo-?o-EB-??-?-o??BM-??---??o?--oo
MoB--?o-B-M--B?BB-----BMM??-M?-o-MB-?oE-oM--?o?oE-?-?o-?oMooM---B---------o--o??--?--o---------o---o--o---------o-oo?-----?---?o-?-?o----o?-EoooMo?E--M-oEEEBBooB-?-ME-o---??o?oo?--MM----oBMEo-o?EMo-oo
Eoo-?BE?-MoM????-ooBoo?o???---B?-??oBoB?-?oE?oBEMMBoE?oBM-??BB-o?-o---?oo----o--oo-?-oo?--o?--o-----------o????--?-o-?--------------?Bo?-o??Bo--EB--E-EB?-BB?o???Mo?--B--EoBoMB--M-E-oBoMo-oo??-oM?o--oo
-BB?B?B-M-B?oEo-oM?o?--oo?E-o?Bo--??o-MB--?BB??MoB???-Bo-?-oo---o-?--o-o-?o-?o?--o---o-?--ooo??-o???----oo---?---?--o--???-o?o--o--?--oEo-BE-EEE?--??--o??B??--M-?-o?M-?M?-?ooB?-BoBBMoBE?B?ooE-o--??-oo
M--oB?oM?EBMM?M-?o--oE-?M?-?B?Bo-o-o-o-o-oB?--EM?oM-EoMoo-o?MoM?B----o---?--o--o-o?-oo---??--??------?o-?------o?----oo----o---o??o--EoB-oMBoM?MEMo?o?oo-oEoo?-BBo-ooo--?-?B?-MM?-M?BE-oB-M-ooM?o??E?-oo
M?EBBo-?B-?o?-?oB-o?M-o??-o-M?-o-?MEoE--MB--E-oMo-?MoB?-??-ooEM?o?----?--o??-o---oo---o?--o--?o-o----?-----o?o-??-------?----o-o-o?--??BoMo--M?-M?--Eo??-??o-EB?--E-oo-?E-?Mo--?oB-?-M?---??BM--M-o-o-oo
o-??MBM-B??BB?oEBo---?MM--Eo?E??oMoBMB?-E?oEBEBB---oME-oM-MooM--o------?o---?o--o?o-o??o--?--oo?--o?----o------?-------?-o-o--o?oo-oB-B-??-oo?Moo?M?BMo-?EB-ooMB-oBo-M-BMooo-EM-?o-o??BMM-?o--?o?-?---oo
E?o--oMoo?M?Mo-M?M-?E?-??EBBo--B--o-oEMMBEB?o-Mo??ooo??-??--MB------o-?--o---?o----?o--------?o--?-oo----oo--o??---o-?--?o-----oo???o?-E?MoB-?-?o?-ooM--M?-o-??o?o-oB?E-B?M?oM--MM-oo?BB--o--EE-?---?voo
B--oo--oo?-E?BMo-oo-BMoBM?oMoo??o--?B-?-??-?-oo?o?o--?-oo??oMB-?--o--?-o--?--o------?---?-??-o?o-??--?--o--?-oo-o-??oo-?-o-oo--oo--??Bo?oEBB?o-BooB?-oo-MEEo?o-?---E-??BooEEMoo-E-?B?oB-EoB--BBo-?M-Mfoo
-EMoooo?E--?B-??Eo?oE??-B--E--?-M?-ooMM-oB?E-?o-o-B-MME-?-M-??o-?----?-o--ooo??-??--?---oo??oo??-o?----o-?-?-o-o--?-o?--oo?o-o--?--??B-oEoBo-?-BMB?--?B-?B---B-oo--B?B--?-oo?o--B--o?o-??-BooM-?-E?Eofoo
?B-oM-?-?o------M-?o??o??-BBo-M??o???o?B--MM-B-oB??---BoooM-B??Eo--?-----o??--?-o-o----?-?-??--?--o---??-o-o--o------??o?--?--------E?BMB-M?B-o?-B???-o?Mo?-Eooo-oo?ooB??M-oBBoMMo??B-oE??--oooBoMEBBfoo
--BB-B-????MM--Bo??-oE-M--M?B?-o-?o-?M--o--??--oMMo?Booo-?oB-BM??o---o?-----?--o-o-o--??-o-??--o---oo-?--oo-?-?--?-o--?-oo-?oo---?---o-B-E-o-B?o-o-o?MEo-B-ooBM---o?BoBMBM-o-o?-MB--Mo?M?oooo?MEBB-oofoo
-o?Mooo-BB?M??-M-BoBoB-ooo-?o-Moo?MM-BBo?M-E?o?Eo--??-?-?o---ToM-?--------------?-o-----?o---??---o-??-oo-o-?-?----o--o-?o-o----o-ooB?BME-BE?--BM??-T?B?o-oB?EoM?BEBB-?oo-M?E-?-o-??Bo--o-ooM?--ME-?-foo
Bo-?-E-Bo-TM?B--MM-Too--EB?MoBMo?o??o?-o?---B?M?E-oTM--TE?Moo|-T?---oo-o--?oo-?--o?o?o---o---o----?-o--?---o-?--ooo---?--o-o?-??-?--EB--ooBM-EBo---o|-B-BB?-E-TMT?M-TooM-o??-T-ooo-o--?o-?o?ETooTTEBMfoo
m??Bo-?ooo|----??E?|??BBB-??E-Bo-?-oBoMBEoMEoE?MMo-|-BM|??M?M|?|-oo?--oo?-------?--?---?-?---?---????-o--o-o-o?--o-o?o?o-oo---o--?-o-MEBoo?---?oBEoE|-?-E?o?B?|?|-oB|E-o?----|?-BoBEoE---?--B|B?||MMBfoo
XXXXXXXXXXXXXXXXXXXXXXXXXXXXXXXXXXXXXXXXXXXXXXXXXXXXXXXXXXX-XXXXXXXXXXXXXXXXXX-XXXXXXXXXXXXXXXXXXXXXXXXXXXXXXXXXXXXXXXXXXXXXXXXXXXXXXXXXXXXXXXXXXXXXXXXXXXXXXXXXXXXXXXX-XXXXXXXXXXXXXX-----XXXXXXXXXXfXX
