E-EM?o-MB-M?--oo-?-o-o-BooM-E-B--oEoB-o-o-oE-B---Eo?-M--BBB--?-o--o--o-B----oE?-BBMo---?B-o---ooB-?E--B--oBB--BMB---B---oo-?oBEEMo?oM---M--?E---?BM--BB-BBE-E??B--E???--oB-M---?MB---M?---oE-o--?---M-oo
M--o---Mo--BE--ME??--oE?-B--ME-B?---oM-MoMo?oo-E--E?--B--Mo-o-------MEBBM--M?MMM-----E-----o--o-o-oM--?oo-?BoM-?-E--?M-----oMMM-oMo-MEo--M---M?-BM-o-o-B-MMM--?Eo-MEo-?--EE-?B?---o-M------MBB-o---E--oo
B--?B--?---?M?-?M?---??-??----?-?M?M-Mo-M-BE?-?--MBBooo??M-MMEM---MB-?M-o-o-M--MMM-?---o-o--BBE?--B---BB-?----B-?----M-?----B-Boo-Eo-MEM---o--E--Bo?----MBMo?----oMBMB-B?M--BoM--oo?o-EB-MMBE-?-M?----oo
BM--B-B??-B--oE?-B?o---oEEo-?oM?B-M---B--o--E-?---M?-oB----o-B-o-MoE-?------?M---?--?---?o??-oM-MoBo?-?-B??-M-BM-EMoB-E--?B-o--?-o---MBMMEooEM?E----EoBE----B?-oo--MM---BMo-M-BooB--o-o-ooo--E?-M-o---oo
M?--?BMo--o-o----MMoE-?-M??------oM-----?-?-------?--E-BoM-?o-oo-oM----oo---E-EME-BBo?--M-B--MMoo-?B?-B-MooMB-o?-B?-o---??EB-o?-?-M?oMBM--B-B----??o?-E--?-o--E--Eo--oB-E---ME-M?--?-o-E---ME----o-B--oo
Bo--???-M-MM--?BE-B-?BMB??M-?-?-Eo?Mo?--o-BBMoMEE-B-o---?EM-M--E-?--o?-?-M--M-----M-o-----M-oEoB-----o--o?B-B-MBMoBEEoM---BoB-B?---BB?o--o--E-??B-B?--MM?-Bo--BB--??-M?o?----MB----EB-M--oE-BEoB?-E-o-oo
oo?-?o--M-E--M-EM-?ooB--E-B---oo-E?-E--?Bo--MoM-M-M?------o-Mo-o---?------B-Mo--oo-?-M-B-Mo---?M--E?B-?-?BE?-BM-B-BM----?--B-M-?-MM?-B-o-?-M?o--E?BoEEoMM-M?o?-BoE?MoM-o?-?BB--M-o-??o--Bo-M-B-Mo-BB--oo
-B?E-B-Bo---MB-B-oE--o--Mo?o?B--EM-EME----o-M?B-Bo-B-?M-------BoBMEEMo--ooM?-EM-??E--BME-BM??M---M--?E--MoM?o--oM-B-o?-B-M-------oB--?M?-M-?E?-M--?-MB???BM--BM--B--E---Bo-M--oM-B-B--M--B---M--?--E-voo
-B?--MM--?M--E-B--B-?ooEMM--o-Bo-----M--oE-?M--B-o---ooM?o--Mo-B-o-MB--?---B-??E-B--oB?-o-?MBBME-B----oE??B--?M?E-BoMM-?-B-o?--oEoM-M-o-oo?-M-M-MM-E?M---o-E--o-o-oo---B--MM--o-M-EoBoM-Mo-B-M-?oM-?ofoo
-MB?--B-B-----M-B?o--oEM-Mo-?MBMMMB?--Bo?-?---?o-o--o?o--?-E?--oE-o---oE-oM?BBMBM----M----o-E-M-o?----M-o-ME?B-B-?oB--o-EB--oBMB--B-----oM?-?--?o-BMM??---?B?---?-BMB-o?E-oME-?-EEMM-B?--oooE-B--M-M?foo
---M-M-E-MEMB--B-?-EE----?----BM-o-o----o?E-oo?M-B--Bo-MoM?B----o-B???--Bo-?--o-?BM-o?EoEM-----?B-B?M-EBEBEM--E--?MMMB---BB-ooB?-BEoMo--o--oM---ME?--Bo-E-oooB-o----oB-----o----?-?B-o-oM-?EB-M?o---Mfoo
o--??MB-BoM---?---oBMoE-o?-?o-Mo?--o-oEoEoME----?M----oM?-MB--o---EE-Mo?-ooBMo---o-Bo??o-M-?----BEo-o-BB--M----M---M?--E?BM---M-----M--B?E-EEo??o-MEo-?-?-E---M-oo-M?oB---o--M-B--o?--BE-M-?MBB--M---foo
Bo----oB?MM-E?----o-?BMB?---?-??--EM-BB---E-M-o-?-oM---oo-EE-BM--M--o----o-ME-B-o-M??-M---o-EM-oo------EoM-?-Moo?M----o?-M---M--oBEB--EBoB-BM--?-E--?o--oMMEo--B?EMMo--o-o-?-?-o--BM-M--ooMB-??-o?-?Mfoo
-o-MTo-B----?--?--M?-MBB--MoBMBBE-?------T?--E---??-?Mo-T-B--BTT--MMT--E-TT-?-Mo-T?-?TM-BM-T---?-o-o-oo?MoEo?o-o-Bo?T--?--E?M?---M-B--TB-oM-ETE----ooo-oB?-M--o--?-M-T?----o-----E-oEEM--T----Eo-?M-Bfoo
mBB-|-o-E-M-BMMBEoB---o-M-?MBo??B-EEBoo?o|B-----?EEBoM-B|ooo-M||-?oM|E---||-oBE?-|--B|oo-??|oEM--?--E--E-o?--?-Boo?o|BM?EEM-?---M-EM-E|oo?---|BoooMME-M-M------M-o-E-|?----E-E-?EM--B-EE-|--oEB?--BBMfoo
XXXXXXXXXXXXXXXXXXXXXXXXXXXXXXXXXXXXXXXXXXX-----XXXXXXXXXXXXXXXXXXXXXXXXXXXXXXXXXXXXXXXXXXXXXXXXXXXXXXXXXXXXXXXXXXXXXXXXXXXXXXXXXXXXXXXXXXXXXXXXXXXXXXXXXX-----XXXXXXXX----XXXXXXXXXXXXXXXXXXXXXXXXXXfXX
