-?--o-MB-o-?--Bo----E?-oME-?-Eo----?E----oBE----o---B--?o---o-o---?-oM-----E-B-----o--oB-----o-oE-Mo---M-M?--?o-BM-BMME------MBoo-M-??-?-oo---?BBMMo-?--?-E----?-M?EEE?--?B-?ME--?-o--Mo-o--M--B?---MM--
BM--MMMM--M-ooMBo-M-BBoM-MB-?-o?----?oMo-oo---?M-?--o-B-----MM---MM-??--o--BBMB---o---E-----o-o?M----o--B-BB?---EMB------B-o-EE-M--MB?-o--?Mo-M-E-M---oE-oMBBooo---M??M--B---?-EoMo?--BMBMM--E-o--E--BBo
----BM-M-----M-M--?-o-ooo--M-??-o-oE------Mo-B-??-Mo---?MBBM-----B-o?-MBM-?--BoM--E--------?-??B---B-EM?B-M-?BMB-?B-oB-----B-?-o-BM--?B-B-B?---o-E--oE-Mo-BE---?-?---?-o-?BoM-B--M-?M------?--Mo-E----oM
BM-o---MEBBM-BEoM??-B---BoE-----M??-EBM------oE-B-M--M-E-Eo--M?-oM---B--E?M-M--?-M-E---Mo-o--oo-Mo-??--??-oM--MBB--MMEoE-o-B---Bo-BB--MM-EM-B--o--E-M-oo--oB-BBM----B-B--BoM??M?o------o---E-E-M------o-
B--??o--M-MB-??-?-BB-o-oo---M-?-Eo-BM?-------o--E-M-oE-?o-----E?M?----?B-M---o-???--?----M---EE-B-?---MBo?-----MoE-oB?M-o--B--?-ME--M-?-o?--M?B-M-M-----------?EM-?-MM-oo-o-?-E-oBEE?-o?--B?--ooBE----o-
M-M?-M-?-----EM---?B?--MBo-o-----o-?--o---BM-?EB-BoEBM--oB?--?---E---?--MB-M-M------oMo--o-B-M?-??-o-?-B?--B-?-o-B-oEEo-MoM-M----MM-----M-o-BEBEEEM-o-o--EE--EB?E-EMo-Eo-BoB---B---B?o-M--?--?B??M-EBM?B
-EB--M-E?--?---Mo-------oE-B--oMB---MMBM-B--E-BE-oB?--o----oME-EM--oo-E-?o-MMBB?o-o--Mo--oo---M----B-o--oEE-BMBooBE-MMMM-M--B?o-M---B??--M-M?M-M?B?--B-oB---o-o--E-BB-M-?o-oB--B?---M-MoMM-MM?oM--BM---M
-----o-?EMo-oBB?-Mo---o--------o-o-oo-E?-oB?M-BM--oo-----BMB-M?M-E--oo--B?Bo-oBEM-Eo-----o-?---o-oo-oo---M---o--M-B-Mo?o---?-E?-?----ooo-?-B---o--?B--?--?-BE---B-----M-o-M---?---M---o?B--B?M--M---BM-v
--MB-EBM??M-BM?---E--MM?-B-oo--B--EM-----B-BM-?M--------o-B---E-BM?-?E?M--------EB?-BEo-?-----o-?-BE-Eoo--B--MB?-o?--?o?--E?o--B--EEE---BM?-E-?-------?------B-??---EE--M--o-B----M?o--B--o---o---B--?-B
-oo-??-EB-E-o-?B-oB-?o?E-?-?E--?E-?M-MMMM-?-E-B--?-M-?E?-B--?-?-oMM---?-Bo--B?MM-EMM------EM--E-o---E??-o-oEMB-B-EB--MMM--M?M--o-o-B-o??MM--?E-?--o--o-----MM--MM-ME?-------B-oE-M?o?B----?-----oE------
oE--o??---?---o--M-?-B-?-?-M-BBBBMo-BMM-?-----E-??-?B-M-E-??MM---M-E-oM--oM--B-?B--?M---M-??-E-?--EBMM-?-E?--ME?-?-?ooM-o--B?--?---?oB--M--???ME--M----M-EB-o-M-oooMB-Mo-E--M?-M?-BMoM?-o--?o-BM--?B?E?o
o?MMM--o-?BMo?o--Eo-----?oMEM?B-B-BEEM?EMBMB---B--o--B--M-----o-B-??-?---o--EB-o?M--o---?oBB--Bo--B-E--E------?-----EooE-M-B-BoMo-M-o-o?-?-------B-ooE--EBMMBE----Mo--E--?B-o-B?M-----?-E--o------Bo-BEo
?--MB-o-E--B-?-T--B----B?o-B-------MB-M-o?-?----?--?-----o-?oMo-?o-MB-----?----??-B??--o?-o-o-o?--EM----oBM--oBEEoME--BB-To--?-M?oE--?Mo----M-BMBB?MBMME---B-M-o----M-?---MBo-?o-ooB-E-EBB-oE----E?EEoBB
-----MToM-EE-?-|T?-o-B-MTBM-?--?-BT-MET-TM-?o?-B-BEBB-??Bo-o--?M-?oT-MM?----E-M-EoM-o-oM--T---------MT--EB?--Bo-?TT?B--o-|------?BB?---ooo-ETo?M--EE-oTBo-B---o-M?-E-M-T-T-?M--TBT---BET-M-MBE--BBoTT-B-
m---oB|-MBMB--E||--E?---|?---?EB?-|E-?|-|oo-E--E-B?-E---o?-E--?MMM-|M?B?E---?--M-B-B??Eoo-|EBE?Mo?oB-|B-BM?oE--MB||EEM?--|-o?-EM?E?BE-?M-Bo-|EEoBE?--M|E?Bo-B??oo-?BB-E|-|-??o-|?|E--M-|MEEMBMM?-Mo||o-?
XXXXXXXXXXXXXXXXXXXXXXXXXXXXXXXXXXXXXXXXXXXXXXXXXXXXXXXXXXXXXXXXXXXXXXXXXXXXXXXXXXXXXXXXXXXXXXXXXXXXXXXXXXXXXXXXXXXXXXXXXXXXXXXXXXXXXXXXXXXXXXXXXXXXXXXXXXXXXXXXXXXXXXXXXXXXXXXXXXXXXXXXXXXXXXXXXXXXXXXX
