?BM-???E-M-M---M-Bo-Mo-?-M---EB-M----??-------Bo------??BME--o--?BMMoM?-o-E-oM---o-?-o?--??B--o?----?M?M-E---MEo-?---?M-o-o--M-?M-B---oMMM?MMo?-B?-B--EB?-MM-?oBEB-??-?EM-----B-B--MB?-?MB--EM--BB----oo
oBE-BB?---ooE---M-Mo--EE-?-ME?--M-E-E-B-?MoM----?o-?EB-Bo-MEo?-B-E-----B---oM-M----MM-BEo--B?---B----M--M??oEo?M-?---o--?--E--M??o??B?----M-M----BM--E??--o-oMB--MEMB?--B??M--BM-o--MM?MM-ooB?-----BM-oo
-BBM--Bo?M-B-?--B-M-B-?Mo--EBBoo-E-M?-o----M-?-BBB--?-B--oM----B-?B-M------oM--E?-E-Eo----?oMBBBMoMo--M---MoMo-MB--M-B-?--o--B----BE-Eo-B?---?---E-o-B--oM-o-BE?Mo?BM-o--oM-oM-MM-E-?-?MMM--M-----?EM-oo
BM--Mo-?-?o--Bo-B-BBMB-oMo----B--MM-?-E--o--o-B-?-E--BEM-E-Eo-B--E-Bo---M---BooBM--o--?--B---E--Mo?-??oo--B-------B?E--EE--MBEM----M------o----o-M??-----BB-M?-Boo---o----?M-B-B?o----B--?-M--M---??B-oo
B--E-M-B-BBo-E-o?-----??-E-B-----?--EEM-Bo---E----Bo-o?----ME-EMo----E-oBE-?MM??EoB---ooB---o---?-EB-B-EMo----?-B--o--EMB-o?EMM-o--MEM-----Eo-o--?-E-?ooE-M-M---o--o-------M-B-B-B--oo--?--M---oo?MoM-oo
EBEBB--M---?-M-?M?MoMB-E?M--E?oM--?EM--M-MM--M-E-o--B-ME?-?oBoBo--oBo??--BE-BB--MM?--ooo--?--M---M??E--Mo---BooM-M-B---BB-BEBM---E?-BB?-Bo?--M-oE-M-M-?---?ME?-B?-----o--?ME-?E-B-o?-?E-M---B?----BMM-oo
-E?oB-Bo----B-o--oB---BM--o--o-o-??BM--o--?B-Eo---?-o?-B-?---BB?EEME-?----B--oM?---???B-B?----M---------M-B-?B----MB-E-o-M--M??-B-BE--?o-B-?-E?-?-?-----Eo--M---?-B---BMBM-??-BooB-------o--B------B--oo
--?E-oMB--MB?--MM---?M--?--o---B-oM-B--M--ME-?-B--B-EEMME-?-o-MB?-B--B-B---E-M---E-?oB?BB-??B?--B-?M?-M-o-?-o---?o-------E-EBE----BMMoB---M--MMMM?-M-----M?-BB-E--o-oB?-EMB--?--BB-M--BoE-----??M-o-Evoo
M-oM-oo?--oBM---o?ooo------?-B--E-B---M--B-Mo---E-Bo--BB---M-M---o----B-M--MM-BM---B-M?oMM?M-o-------??BEM--BB-B?oME?-E--B??-----M?B--M-B----?M-----M---MM---o-Mo-Eo-EM-----o-M---??--?-Bo--M------EMfoo
-E--B-M--?-oo-EB?-BB----o-MMM-----B-E-B--?-oM-ME??o?MoE--B--oM-??--?-oMo-?-?---?o?--o---MB-B---M-?--B-o-?--o--?o-BMBBMB---o?--E----Bo--o-?-MMB??----M-?oMo----EoM?-B-??E---??M-M--E--M--?--E-MM-M-M--foo
-M?o--o-?BBE?-MB-M?-?E-o--MoE?B-----?--M?-BB-oM?-M--M-MM-B-B--E-M--oM??-o---MM--BEM-B---?o--BE-EMBM-B-M-E--?oBEE--M--------?--MBMME?-B?E--o-B?----Bo--?M?o?---MBB-EoEM-----MM-B---?-EM---oM--MB--oB-Bfoo
o?--?-E--oMBEB-EB-B-B-?EEooo--o?-B-M----EBB--BE--?oMoMMMoo--o-BM-M-M?oBo-oB-?--o-??o-oo---M?-?oMMBMM---BTBEo-B?--?M--o?---?B?---EoBB--?-o--o----B-EBM?M---EMMo-?MM--?-o?---BM---oo---o?-o?----Eoo-B--foo
ETE-o-BE?oo-M-oMM-BEBM-BM?----o-----T---?-M--oB--?---M---B-EBM-BB---MB---MoBE---E-oB-Mo-oo-?-M---?---o-E|EMB-?-?o----EM-EBMBo-MoMoB-o--BB----B------?----M?----M-o-M-?-?oM-B--Eo----B---B--BT-MoEMo?ofoo
?|?-MB--M-To--E-???M?M-BTM---T-----o|-----ME-oMMEoE-----o--T---BoEBo?-o?oE--To--B--M-BB--?oM--?o-oTMTB--|BoBE?-o--Mo-T-M?B-oM----ToM--?T-EMB-E-BM---To---T-o-----oBo?ETBo-oM--BTE-----?EBoT-|-M-?M-o-foo
m|o-o--?o?|-ME-B---M?oo?|M---|oEB?E-|M-EoE--E?o-M--?--?-MME|-?oM-M-E------?M|?o--oE----oB??---?M-o|?|Moo|E-o--B?-M--o|--BBE---ooB|-o-?-|-ME?-???M--E|--MM|E-EMo--BMBB-|-M-o-M-?|ME-?E--B--|-|--E-E-E-foo
XXXXXXXXXXXXXXXXXXXXXXXXXXXXXXXXXXXXXXXXXXXXXXXXXXXXXXXXXXXXXXXXXXXXXXXXXXXXXXXXXXXXXXXXXXXXXXXXXXXXXXXXXXXXXXXXXXXXXXXXXXXXXXXXXXXXXXXXXXXXXXXXXXXXXXXXXXXXXXXXXXXXXXXXXXXXXXXXXXXXXXXXXXXXXXXXXXXXXfXX
