-BEB---MM-B------oM-ME-B-oM--BE-?M-ME---?BBM--E-?-?-o--B---MM--Mo--------?M----M-EB-B-MB---------E--BBM-?-ME--B--B-EoEoB-?-E-ooB?BM-?-?-?oM---B-?M-o--?B-MoMM?o--oMo-?---B-M--M?-E?-BoM?E-o---?---??--oo
M-Bo-----M-M?--o-??o---EoB?--?M--o?-??o-B??B-E---?-----o-EMo--E-B-E-o-oB-Mo-M-oE-?---MoM?--B-oM-oBo---M-E-MM----o--BBM--M---oB?-M---MEoooM?M---E-?-oB-M---M-M-B-?-o-M------E---o?-oo-BB-BoEo----M--?--oo
-oMM?E?-oo-BE--o-E-?-M?MMM-o--?M-----Mo-?------o?--BME-?o-?B--?E?--?B-oMM--?MooM-?-?-?---Bo--B-E-----??-----o--BMM-B?--Mo?oM---?M--E-?M?---M---B?-o?ME-oo-?BoEo--EBM---?-?--BMEB---ME-?-oM-?M?MM--B---oo
B--B-M-EM---MBMMo--B---BB--BM-E-M??-?M--?oB-o-Eo-??-MB--E-o--o-BM?-E-E-oBB---E?o--M--M-E?o-?--BM--?o---B------Eo??-BEB-Mo-M----M---M?BMM?--M---o-?-BoME--MM--Mo?oBB---?-?oB-B-MB?-oB-o?-M-o-----B-o---oo
B-E-Mo-BEE--?M--------Mo---BEM?--B?--oM-M?-EoEM--B----BM-M-?-o---Mo-o-EB-ME-o?--EEBEB-oM---?B-M-??---oEEEBBM--?--o-BB------o--oMM-?B-o-Mo---o-?E---oM---B------?o??--BEEB-B-oE--?-B-?---B?B---o-BE--M-oo
--Bo-oEB-?E--Mo?o?M---B-M-o-M?------B-E-----oMM---E-oB-o-B--M---BMBM-?--o-B--ME?-??-oo--o--oMo-?MB-?-----?oB--?oM-oM-oBo-M-M----o---?---MB--?-----B?-M--BoE-----M--o-BBM-M-E-?B?-ooE--?---?-??--B?o?o-oo
--M-BE-o---o-Eo-BBMo-BM-B-oBBM?--?M-o-Mo--EM?-?-oM?E---oB--?-?MBM?--B-oM-----EB-M?--M-Mo-Eo-MMo----B?---?B-M?B--MMBo-?--BM--?M-?-o-?Bo--BMoEM-BB--B-MM?-E-B--M-?M?ME-oo--oBBB----B-ME---o-----?o---Bo-oo
-E----oo-MBEE--?-B?E---o--oEB-oB--E-?E----M--BM-?E-M-MoM--oE-??---o-?---------B-?--MMo?o-B--oMoM--?BMM-Moo?BB-o-M-?-M--B-M-E?Bo-M--M-oBo?--B------o--MEo??o-?B-BE???-?-o--E-BB--oM?-B--B?BoB--MMB?M--voo
-MM----?-B--Mo-oM--M-?----M-BB-----o-Mo-oBEEo-M---M-E----B---oMoMoB?-M----MEE---?--M-EE?-o---M-B-o---M?--M--oM------M------B???o--?---o--EB-M---?B--------o--B-EM--EE-o--BB-o-?--ME-?-B-o--MoE-?-?--Mfoo
-BBM-ooM-M--M---B-MM-B--M?-?--o-ooMoo?-o?oBMB----?BM--B-M-?oMEBEEMo-M?--MMo--ME--?--oM?MoM?BEME---MM-o?o-B-MB?oo-------?--M---M--EM-B---oBoEMBEBM---M?--B??BM?----o--?MBo---B--oo-MM?BM-B--?-?E---E--foo
---?-?-??EEoE-M-BB--B-B-E---o--oEoo----o---oBBM--?--BEME--o?B-BB??-Eo-o--BE?--M-?-E-ME-B-M-o?-?o-?--E-oEB-E-M-?oB?---BM-oo---M-ooM-oM?M?--?BMEMB?--BM---oo?-?---BB--M--MoE-oE---MMEM?E?--EE-?-M?--?-ofoo
--??B--M?-B?M-M-------?o--?-?----o--?--B?-?BB--E--???---M-BBBo--BoM-??--BoBBo?--EB?M?--------B-o---E----MoBMo--M-ooM-----MMo-Mo???-oM-?-?-M-M?-oE??-E-M?-ooB-M---o?---?-o--B--MB---o--?oBB-?MBE------foo
--B-----E-EM?o-B-ooEM-o-T?B?--?--B-ME?--B--M--B--?oBoMo--oB-Mo-B-M-?-?-B-MMoMo--MoE?-M-o--??-M--oB??-----E-?--ooEo-MBoo---B?M-M------?-ET--oM----BE-M?oB------------M---MMT----o--M?--o-B-oEo-MBE--E-foo
o?o-??-EM--M---E-M?B----|--TTT---?----B-E-oBB---E-o-?o?o----MTMT-M---MM?MoEBT?--BoMMo--o-TEETB--T-BM--oM-TME-M--?-M-o--T-MMM-o---o-?B-T-|----EB----BT?--ToM-?Moo?TMB----B-|o??--?M-?-E--M?BMoBM-?EE--foo
mo?EBBo-E-??oo?B?---BM--|--|||--B-M?----?ME--Eoo?EME-Bo-E?-EE|B|?-EE-EB-?-B-|E-E---B-MoM-|-B|EM-|?B-??--B|E-M-EM?-o?MB-|---?------oooM|-|M-B--?--B-M|-E-|BM?B??--|--o-E--M|M--MEB?---?M?--E-o-?M--?BMfoo
XXXXXXXXXXXXXXXXXXXXXXXXXXXXXXXXXXXXXXXXXXXXXXXXXXXXXXXXXXXXXXXXXXXXXXXXXXXXXXXXXXXXXXXXXXXXXXXXXXXXXXXXXXXXXXXXXXXXXXXXXXXXXXXXXXXXXXXXXXXXXXXXXXXXXXXXXXXXXXXXXXXXXXXXXXXXXXXXXXXXXXXXXXXXXXXXXXXXXfXX
