-B?B------?BMoBB-E-oo?--M-EMMo--?--o?E-M?-----?--Boo--o----?-BB-?---?oB?---o-M?o---M--M-oo--?M----o-?-BB---E-M?-M-o?-Bo-M-E-B------E-o-EBM-?BEMB-EMB---M--B--B--?-?---M-M----EEMo----?---B----ooo-M---oo
o---oo-o?-B??-B-o?-MoEM-BEB-??-BoBM-B-oB--oE--M---M--o?--E-BE--M--M--M-B-BM?Bo----MMEooBE-o--BMoo--oB?----E?---?--MM-??E-M----E--MM-BMEBB--EMM---MMB-M-?-----B--E?-o--BBM?B-??-o-M-o---EEoo-E-M?---oE-oo
-BBEB--?--??-?oM----E---EM--M?B-BoMoEM-o--B--B?B--oEMM?E-?--MBB--oM-B---?----E-oE-Eo-EB--?-?-o?M-Mo-B------oBM-M-BM---E-BEE?o----MM--M--EBoMMMMoBB---BM?-B---oo-B-M---?-M-------?oEM--oMM-------EE-?B-oo
-EMB-Eoo--E--E-B-MM?-----M----?-?----BME------M-?-o---MBB?-Boo--??oo-?-?M-M---o-M--oBM-o-----E---MMM-??MM-MEBo---EB-B-Moo-M-M-?-?--?M--o-BM----?-?BBoE?BMBE-E--Bo?-----o-B-B---oB?B-oB---o-?-o--??o?--oo
--?-?-M---B-M?--o?-?B----o--M-E-MMo?o----M-----------M?--E-?----?o?-o-B?E--?MoM?M--MM-M--M--MM?B-BM?----Mo??oM-B------MM--Mo---BE--B?-----M?---?--o-?-Eo-E?oM-ooM--M-?--o-M-B----o----?----E---E-E?---oo
-E?----BM--?BM-?MoE?MM--BB?-BMMEB-B---M-o?BB--o?oo-B--o-?M--Eo?-B-?-oM?BM--B-?-o?-BBo-?Mo?oo?-?----M-?o-Mo----MM--B--B-??M?M--M---o-?--M----B?EB--B-M?Mo-??--M--M--MMEo-?MooM-?--B???oE--oEM--E?BM--?-oo
---?--??ME?MB--?ooM?-Bo-oo?--o---o-MM??---?-MB-M?---M-o-o-Bo?--o---?o-?---?o------Eo-Eooo---??--oE----E-----B-B-B-???-E-??-----oM--ME-?---?BE-B--?E--o--?--oE--oo?---MM--?Eo--o-B-o?EMMoM--------B-E--oo
---o-BM-o-MMo?oBM-?MBM-E--B-?--o?M--MB----E?---o-o?oM-M?---Moo--oo---ooB?o--?EM?----M---oMM-B--?MMo-Eo?---oBMB--?-?B--?M----o?EMo-oB?--o-Mo-B-?-M---oMM-M?-MB--M-M---M--BoB?-BoBMBEMMoEEMB--E--EB-oMMvoo
o-M??o-BEB-o-o-?--B--Mo-B-oMMB-MoBM?-M----B-----o---o?oME--B?E---------BBoMMB----o-----M-MB-o-B-E--o?-o---o----?-EoB-oMMo----?B-EoB?-M-Bo----o-EMEo-BMBo?M-?-oo--?BMMM---?-B----M-?-?B-B---oBoMMM--?Bfoo
M-?MoB--M?oB-?M-MB----o-----oo-----EE-??--?----Mo--?o------M--oBE--M?M-E?--B--B-EM--o?-o--oMBMM-B-o-----ME-B-EE?M--E--???Mo-Eo-?-Mo---E------?---?B-MBM?o?BMB--BEo?o-Bo?M-M?-oEBoo-M-?Bo---?---M?o?-?foo
MM-B-MBM---o-o--?----M-?E-B-B?-EM--B-----o?---??BB?--?MB?M---oB??---MEB?-EB---Bo?-ME-MoB-B-MMM----M-o--M-B--EM?E--?Bo?E-MME-B-B---oMBM---B----?-o-o-BM--------?--M?MM--?Mo-B-B?---oo-B----o-E--o-B---foo
BoM--B--?---?----o-M--Bo?---EM-?ooB??----BE-MB-ooMoM-o--?--B-B?-?B-E--BM?MoM-?-Eo-M?-?-B--B?E?----BoMoM--Mo-?--?Bo-o-M--oM--BoB--BEM-----BBoMMM-o-MEB-----?----o----?--B-oE--EBo-o?Bo--B-EBo--o---oMEfoo
---o-E-?-o-o---E-?--?-?-----MBMooM?---o-o-?---?-----?E-oMMEB-----M-----EB?B-MBM?-EBB-?-???-EM-ooE-M?--B?oo?E-----M--BE--E--MM----MT---oMo--Bo--o--?-M--BEB-?E-oo-----o-B?MTo--B------o---?---o?-M?-?-foo
-BMETTM-MoB-T?-?-MoEB-oB-ToMTEo---TBMB-E-B-E-----?---M--oBB--ToMM--?--BB?-?-B-o--B-MoBMEToEM---M--BT--B-oo---M-BMo-BT-T---BBEMM-?T|o??--BTo?--MM-EoME-E-TM--M-?--MEMEM?-M-|--M---M-M---M-B?B-ET-o----foo
m-E-||?--?Mo|BEME-?MB-BE?|-B|--EEB|-o?-B--MMB-Mo-E?o--?ME--oo|?MB-E?o----E?BMBM--B-BME-?|---E--Mo-o|-o?EE-o-E--E-?o-|-|-E-B-M---E||-E---B|-M?------o-?Mo|o-?o??E----BM??-o|B--MEEB--M-o-BM--EM|oooM?Efoo
XXXXXXXXXXXXXXXXXXXXXXXXXXXXXXXXXXXXXXXXXXXXXXXXXXXXXXXXXXXXXXXXXXXXXXXXXXXXXXXXXXXXXXXXXXXXXXXXXXXXXXXXXXXXXXXXXXXXXXXXXXXXXXXXXXXXXXXXXXXXXXXXXXXXXXXXXXXXXXXXXXXXXXXXXXXXXXXXXXXXXXXXXXXXXXXXXXXXXfXX
