?oM?-o-B--E?M-Mo??----?-B--?B?MM-B-oBM--o------E?--o-B--------M---oB--BM-o--B??-BM-o-Boo?--ME-BE---B-o----BMM---o-?--M?E?-??--E---E?-Bo-Mo--Bo-MM--E-Bo?EBoB?---E?B--?-MoM--?Mo-?--?o-M?oooo--?B---MM-oo
-B--M?-??o?-o?---oE?B-?-M-B-BE-o-??o----MM-MBBE-?----?M-?--o--B-?MB-BoBooBMo-?--oo--BM-o--E-?-----?--?-MoM-----oMMo--MoM--E-oE?--o---?oE-B?E-M-------B?--Bo-M?BB----BM--BE--M?MB-MM?B--o-?-B---oM--M?-oo
-?EM?-MoBoE-oM---o--E---?-Mo-M--o--oBoM-BMB-BB----B--B---o------E-MBBMo-B-oM-B--B-M--BEo-?----E--?-?---oMM-EB--MEEoo?--BM?--?M------o-o?o??M--??o------oMME?Mo-oB----BoMB---MB---M--oo-Bo-E--oM--M?Mo-oo
oM-B---o-M-BB-----?-?o---MB-MoE?MB--M--B-M-?-oBo--oE-o---oBo-BoM?-?---E---o?o-E--oB----Mo-----M-ME-B-B-oo---o-B-?M---oB-Mo-BooM--o-ME--EMo-?B??BMMBo-MoBoB--o?----Eoo--E-B?B-BEEoE--BoE?-BM--MEBo-Mo?-oo
?--?MEE-o?BB?--?-----Mo-Bo---M----o-?---o----Bo?-B----BMM----o--o-BM?--M-oM--BM-E--ME?-o-M--E--Bo-E?-BoEEo-----MM-?-B-M-EM--B?M-o-?M---M-?E?----B--B----?B?-B-----M---E-E---MoM-M-B----??-------?--M--oo
B-ooMMBB--M?B--M--B-B-MM-M---?--Eoo--BBo-o-o?BM-o-o-MEMM-B---o-oE-?---o?B-M-B--???--?--M---BBMBBE-?-?-o-M-MB-?B-M-B-B-B-?E?--oo-Bo--Boo?-?--M-----o-?B--Mo-BM--MBMBMB?-oBE--?M---M--B--B-E---??-o---B-oo
EoB-oMB-BoM-B--M---M---M--E-oo--M-Mo---M-B-B-M------o?B?-----oBo?-oo---?-o-o----o-E---B--?-E----M----?Bo---??--o-E--E-o--B--oMBBo-oEo-------?oM?-E--o?oB----B-E?--o---BB-?--E-----B?-MB-oB-ME-----oEM-oo
M-B-?-M--?E-ME-B-?BBo-Eo-BMM-?-E-?----M?-B--o---?EME--MoE?E--------MBoM-M-B-o--M-----o?-oEo?---B-?ME-Bo?-M?--EE-B-E-M----E---Eo---MMB--Boo---Bo-oB-BBE--oEMo-M-M--oM-?-M--o?-?----??-B---B--?EE--B-BMvoo
--?o-oM?BM?-B--o--?--oM-BE--o-?-----?--?--M-o----???-?-E--?M--M---E--oM--M---MB--?B----M-?--B?-B-MM-M---o--?---oo-B-BMM--?--E-oM--oE?----o-o---BoBo-o?B--B-E-B-BM-M?--oEBB----?EBooB--oM--E?--B-?---Bfoo
--oB----oM?--M-?-BBo---?-B?-?B-?o-?o-E--E-MoM-o-MM-o--MMB-MBMoooBM?-?-M??B-o-oB--Mo-??B-o-B----?--M-o-E-oE---BB-E?B----M---B-B---oo-M-oo-?-?o-------ME-B--?MM-B--M------o---M-o--?-oM-o--o?Mo-BM--ooMfoo
oM--?-o-E-o--M-B-----?-MB?B-o-oMM-oB-M-o--o?MBMoM--MM-o---E--ooB-M-----------??-?B-o-o-----E-oBo?--M---B-M--------MMM?Eo?-B-B--M--MB-?-Mo-o--E?--o-----?-o-Eo?--ME----MM-----M?--?B-o--B-?--BMM-M---Mfoo
-o?-EMMMM-MoE-M--?-oMM-M--B--MBM-??-?E--M?---Mo-----E-?MB-Mo-M-T-M-----E?-EE------Mo--M-oM-B---?MBM-?B?--EM--BE-M-o--E?-B-oB?B?-------E-B--oo-B-?Bo-E--Mo-MM-BB-o--EB------M-Mo-?B?---MME-o-----o----foo
-?--B--MB----M?ooE----TMoM?oMEE-E--MMMoBoM?-M--B-M-?---Mo??B---|T-oBo--Moo?B-------BoE--BEE--o-oE-----M-oMBE-MM-B-B---M-M-?---B-o?B--M-?--BoM?E--M-----BB---M-T?E--M?------oBBo---B-Bo?-?BE-M--E-?-o-foo
M---MET---TMMMoM--?o-o|E-T--T??o--?-??T---o-Mo-BTM---?T?B--o?--||o----B-B?-T?-Tooo--B?TM-M------MEBBT-M-?-M-----B-BoB?-B-MEBEB-Boo---o--Mo--?EBToB-MBT-Mo--BBo|EBE?-E--TTM--M-BT-o--MB---?-T-EoBB-T--foo
mE-MMB|oMM|MEo?-EMMM??|M?|--|o-E??EEE?|oo-EMM?oE|BEMM-|BE-??--o||B?M---o-BE|-E|-Bo--B-|-EEM?----?Mo-|o--o-M-?-E-?M--BB-?ooB-?B-M?ME?ooBEM-oo-Bo|oMMB-|Mo-B---E|?-B---EE||MMB---|o-MMo-?M-B?|o-B-Eo|-Efoo
XXXXXXXXXXXXXXXXXXXXXXXXXXXXXXXXXXXXXXXXXXXXXXXXXXXXXXXXXXXXXXXXXXXXXXXXXXXXXXXXXXXXXXXXXXXXXXXXXXXXXXXXXXXXXXXXXXXXXXXXXXXXXXXXXXXXXXXXXXXXXXXXXXXXXXXXXXXXXXXXXXXXXXXXXXXXXXXXXXXXXXXXXXXXXXXXXXXXXfXX
