B------M-?-M-M?MEooE?EEM?o-o-M-o--oB--MMMo-M-o-MMB--M?MBoEE-oME-M-MM?ooo-B-?Bo-B--?M-MM----??--MM?Eo--B-o--E--MB--E---MBB-oEMB?-EB-M---?--?-o-B?-B-?--oM-M?B-B-EM----?o???M-B-M?----BoBo---------oMBo-oo
-?E?M-o--------B-----BBoM-Bo??MB?-B?o--B-------??--MMMB--MBM??--M----B-o--?-o--?-o?M---E-BE---oMB--B-o-E?B--o?-M?-M--o-oo------o?-B?Mo-?-EBBEB--E-E-B------E-o-?-?----o-o-MMM-M-B-?E?--?-o-B--------B-oo
-?B--Eo-B--EEo-oo--o?M-B--B-----B--?--?o?---B?-B--Boo-E-Eo??-E-BoME-EoM-B-?---B-ME--E--M---?---MM--o---M-?--o--?---?M-BMEE--B---o-M--B???M?-M--o?-B-oMM--EMM-?E-oooBo--EE---?---o-oBM--oo?--??-?B-??--oo
-E?--B?---B---?Eo?-o----B--B---E-EB-B-?---M------M---oB----EBMoE-?MM-MMB?--MM---o----o-o---EE-E---M-MMoBo-BB-oo--M---?EoM--oMMo--MEEEE?-MEB---??oE--o?---ME?--??-??--Bo?B--o--MBoBE---o-B-?o---M--E---oo
----?ooM---BM--B?o-------EB--oB--B-M?MoM?-?-BEo-M--ooM-?M--?---M-M-M---B--MEE---E-oMEM?Bo------EBEMBM-M--?--?oM---oMo-M-EooM-M----B-B?-----MoB-?BMB----ooE-o-o--B---Eooo?---------MoM-?M--B-oE-??o--?-oo
-o-?M---M------?-BMM-BBE-M---M--EEB-E----M------o---M---?ooMB-M-B-oEB??M?-?B--oB-B?--B?o-oB-o--------B-o---o--oo--BM-BB--o-E?E--B--o----o-B-M-?M?-?oM--?-M?--oB------B--M-??Eo-M?-E-B----?-M-?-?--M---oo
-o--BM?MB-------Mo?-oo------oBE-?-----BEB--o--BoB-MME??Bo--o--BMBE?BBMB?-M?E--o?-EB?M-?-?M-----oMMM-?--BEE-----E---M--Mo-B-?B??----E-oooBM?o-?M-E-M?B--BMM-?-M-Eo-B--oBB-----?--B-?--EEo-o--?--M-oo---oo
?-o-----B---E?M-oM-M-?M?M-M-M?-BM-Mo-oM-MEMM-Mo-M-B---o---?o??-Mo--Bo--?Mo--BB---M?M??-?-?--BM-Mo-MB?-o--?-?BB--BooEo-ME-M--?-?---E------o---M-E?o----oB-o-------ooB-oM?-----o?M-----M?-B---B-E--M-?-voo
---M-?M----E-E-o-M-M--BoBMMM-?---MB-oo---BooEB?-------?----B---B------M--o-M???-?--?-?-M--MMB-Bo-??--oB---M--Mo--E-?B--?M-E--BBo--BMBBME-?BM-oM?o--?-oME?-?----?o----?--Mo--M----Eo?--?----B--MoB-BBMfoo
-MMoo-B----M?M?-oBBB-ME-BM--M-o-?B--B-o?-EM?M-?---o-o-oo-?--o-o-Bo-Bo--BoM-E?---BM--o--E-E-?M-oB--B--M-oM-B-?-EMo---o?oo-B?--E--E?-?M--?-oM-??-M-o-o-Mo?B-o---o---M-EMoMo-??--oBo--o-Bo-oo?--B-Eo---Efoo
M---EM--EooB----o?MM--?-?E-----?-?-M---M--EB----?MBB-B-MB-M---o-o-B-E---??-B-?-M?-?o-?E-o?-B-E?oB--o--M--o-----Eo---ME-Bo------EM--E---?--EB-M?o---M-BE-?---o-?EB--oBEB?Boo--B-?M--oME?B---Eo?MB--o?Bfoo
M-oo??MB?-BM------BME------?-M---B-?-B-------EBM-E--o---?-B----M?-M??--Mo-?-o--?M----BME--oo----oEE-?EB--MoM---B--?oM-BoM-ME---BB?BB-?B--M?-B--o-?-BBoMB-B--M--??-?M-B-?-B-BE?BMB-Eo-------BB?-o----Efoo
o?--B?--M-M?BBM?---M-E?M-B--?oE-E?--o-EBo---M-MEBMBo-----MBMo-oE?-?Bo--?-----M-MB--T----E?-?-----?B-?-EBo-----oM--M-?-?--o--------E--?oBB----oEEo-?o-o-B--o?--E-B-oM?M--Bo-BB?-oBB-o-oB--MoooM---??-?foo
-M?--o--M-EM--M-oEB--M-E---?-MMB-BoM-MB?--Eo-B--B?BM---M-?-??-?MMoBEE-T-?--MTBEM---|?T---T-M-?-MBEETM--T-B--o-o?--T??-BBo?---B-?---o--T?-T?TM-T---B--o--BooB-M--BE-EM-TME-M?T-o-T-?MB-oB-EE---o-TT---foo
m?------MM???E-E-BE----?MMEBB--??-E--?------BE?MB--?M?BB-Eo?Bo--M-o---|B--E-|M-M---|E|oM?|-E-ME---M|EoM|?-MEoo--B-|-oEoEoB??E-E--M---B|--|o|--|EoME-B?---ME-B-oBE-o?EM|?BM?-|ME-|E--o-M--B?B-EoE||B--foo
XXXXXXXXXXXXXXXXXXXXXXXXXXXXXXXXXXXXXXXXXXXXXXXXXXXXXXXXXXXXXXXXXXXXXXXXXXXXXXXXXXXXXXXXXXXXXXXXXXXXXXXXXXXXXXXXXXXXXXXXXXXXXXXXXXXXXXXXXXXXXXXXXXXXXXXXXXXXXXXXXXXXXXXXXXXXXXXXXXXXXXXXXXXXXXXXXXXXXfXX
