o?-ME-MM--o?Eo-oM---?-ooBE-?o??o-MBoo-o?o-BBooMMo-oo??-MM??Mo--B--o?o---M--EMo?-?--?---Boo-Eo??o?---------o--o---o?-o------o-----o?-o---o---?-o---?---o?---?o?-?--?-?oo?E--EMo-?-BoooB?EBM-??-o-??-??-oo
-?---?oM-EMB?-?BoM???-?--BBooo-B-oMEM?-?--?oBB---o--?Bo-oM-oM--?BB?M----Eo-?MoB?-o-Bo-B-B--??ooo?-E?-----?--------------?-oo----?------?o---?o?--?o--??----o--------M?M???Eo-E?B-?E?E-?B--oBMEo-o?EMo-oo
-oo?BM---B-oME-B?-?B-oB-?o--E-?-Bo-o-ooBB??oo?----?Mo-MB-o-oBB-o?B?-?-?-M---??-?-o-??-B?Eo?-o-?oMMB--?-o??--?----?o-o?-?-o?o-o--o??--?-?o?--o-----o?-o-ooo?-?-o---?-?MB?MoMBo?-B?-?-?o-oM-?oo?-?-M?o--oo
o-?Mo?o--oE-M?oBM?-oB?-BBooM?-oo?o-E-?ME--???o---ooBM?oo?Eo-o-o--o?---???o-B?--Eo-o-o-?BME-o?-o-oMo-----?--?--?---oo--o--?o--??-oo-----oo---o------ooo-o---------?o?MBMM-?EoEo?---Bo??MME?B?ooE-o--??-oo
-oB-?-E-Bo-M-BoE-?BB--ooBMMoBBoo??-?M?B?M-?oE?o-???o?o??o?o?MoM?B?oB?--?EM?-MMoB--oB-MooMBM??--??M?-o---?--??o----?-o----o-oo-?-o?-?--oo---o-?o?-?-o--??--oo?--?-?o-?--M?-?o?--M-o?BooB?B?M-ooM-o--E?-oo
-?-E--B-B?-B-?BMMBoBoo-Mo---oM---o-??E-oBM--B?-oM--oo?B?o-MooEM?o---o?o??o?o?MEB--B-oo-?EMMo-??Mo?---o----o?-o?-??--??-?--oo----?-o------o-?o-o???-o-o??-----------?o?oBM-oo?--M-oB?BM?-???-BM--M-o-o-oo
--o--o?oBBEB?M--??ooB?-?o?o?o-?o--?-?B?E?--?oMMB-oBoEoEoB--o?M-??o-M?--oBB?o?---E--o-o-oM?Mo-ooEB-Mo--?-?------??o-o-?---????----?---?--?o-o---o----?----ooo---????-o-M?--oE?BoE-oMMEBBBM-oo?o?o?o?o?-oo
-EoEEB-E?oM-EoB-oo---E?oBo??-?MoB?Boo?-???M-?BM?-oM-?-BEo-EoMB?-?--o--?--Bo?oMoo??-??-E??oE-o-?Bo--?-?-o---o--?--?--o-?-??-?---------o?----o--?--oo?----?o?--?o-o-??---M-MM--oB?oo??--M?-----EE??-?--voo
B--?-o?o?-M?M?M-Mo??-o-E-ooo??B-M?M-M?-M-B--B-BE-EoB-Mo-o---MB-o---?----B?-B?-o?oo---oo?oo?EM??Eo-Mo?---o---?-o--?o?-ooo??-?---o------------o---------??---?-?--o--oooEM----MB?-?----M--EoB-?BBo-oM-Mfoo
-BE-M-EB----oo-M?M?o??--?oB---?-oE-o-??MoB?oM?-?-Mo?M?o-EM--??o-?oMMoo-o?M--oB?-E---oo?B-?-B??o--oB?-oo?o-?-?----?-??--???--o--o--?--?--?--?-o?o-??-o--o-o-??-o-----M-Mo???-??o-???-o?MoooBo?Mo??E-Eofoo
-oMB-?-o-o?o??B--M?--oMBoM-??ooB---M-oE-o?o-?-oMo?M-ooo-?o--B??E?o--?-o-?-E--?-oM?-EB?-Bo??-oo??o-----o-----o---?o-?---o------ooo??-o??---o--o-?o--?----o-o--?----oooM-oooooo-?B?B?E-o-B???-o-oBoMEBBfoo
B?BBoMB--?-o--oo--o?B---MB-o-?o?----EB-----????oo-B-?M-oo-oBoBM?-?o--oo-E--ooo?o?-oM?--?B-?ooBM---oo----o-oo--o?-----??-----?-??-?o-o--?-?o-o-?ooo--o--?-?o?-?-?----oEoB-M?oE---?oooM?oM-oooo?MEBB--ofoo
-ME--?BoE-BMMM--M-?ooBB-BoB---EEE-o-???oMMMM?---oooMoooo??---T-M-?B?-??--oo-????oBBoo?E?--o?M?Eo-MB--------o-??--o--?o?---???-???--o-?---?--o?-o?-?-ooo--?-ooo?--o-o-?-B-MB?B---Bo--?M--o?--M?-?ME---foo
oo?T?T???To?BooE-ET-o--TB?T-?B-??M??-MBE-Too-ToE?T?-o-??BoMoo|-T?TT?--?-?-B-MooBT?M---?BoE--oM??-?T--?o-?o--?o-?------o---?--???--o--?oo-----o?oo?-o-?-o--?---o--?-oT--MM--??--?BoEM-?oEo?o?ETooTTEBMfoo
mE?|o|-Eo|---EoMoB|--MB|-E|oo?B--o-?-?oBB|E?E|?ME|o-o?ooEoE?M|?|?||ooo---o?MoB-M|Boo-ooM??oM-oEoBo|?o-o-o-??o--?----??-o-o--o----?--??--??o--??o-------o--oo-??---?-|????oo-?Eoo?o?o???Mo??-B|B?||MMBfoo
XXXXXXXXXXXXXXXXX-XXXXXXXXXXXXXXXXXXX---XXXXXXXXXXXXXXXXXXXXXXXXXXXXXXXXXXXXXXXXXXXXX---XXXXX----XXXXXXXXXXXXXXXXXXXXXXXXXXXXXXXXXXXXXXXXXXXXXXXXXXXXXXXXXXXXXXXXXXXXXXXXXXXXXXXXXXXXXXXXXXXXXXXXXXXXfXX
