E-EM?o-MB-Mo-o-o-?-o---BooM-E-B--oooB-o-o-oE-B--?Eo--M--BBB--?------?M-oEB?-?-?-?-?B-?M-------??M?-MEMBo-?M-BB?BM---Bo-B-o-E-MMEM-M-oo---B-o?BM-o---o??--oM-?BoMBoE-E-B?-MMEB?-oBB-M--E?B--?BBo-------oo
M--E---Mo--BE--ME??o--E?-B--ME-B?---oM-M?M-?oo-E-?E?--B--Mo-o----o--o--MB?o------M--?-------oo?M-o?E??-o?M----M??-B-B-oMMEB?BBo-ooB--?MB?--M--MBMM?----?-M-o--o--MM-BM?Eo-B--BB-?E--?o-MooooBME?o-o---oo
B--?B--?----M??oM?---??-??------?M?M-Mo-M?BE?-??-MBBo-E??M-MMEM---MMMBM-MMB-B--?oB---E--M?M?-??-oM?BB---MBo--M--M-----??o?-?o?---o-ooM?-???Mo--ME-MoEMo-M??o-EEM-----?-?-BBM-B-o-Moo-?-----M?oMBB---E-oo
BM--B-B??-B-?oEo-B?o---?oEo-?-M?B-M---B--o--E-?-?-M--oB----o-B-o-Mo-o--Bo?-?--o---M-?MoMMM?-E-BM?-M-o?o?-o---oM--?Eo?o-----BBo-M--o-B-o?-B-?--M--M?---?-M?---?MM-E?----BMEoM-oB?MBM--M-?-oo?--oo-o-BB-oo
Mo--?BMoo-o-o----MMoE-?-M??-----?-Mo------?-------?o-E-BoM--o-oo-oM-o-o-B??EM--oM--BoE-----E?-B?EB-----B?o-?--MEo?oE-o-Mo-???---M---M-M-?o-B--B-B-B-o--M?-oB-?---?M?M??--?-M?-M-BB----?M?----E?-?-ME?-oo
Bo--??--M?MM--?BE-B--BMB?-M-?-?-Eo?Mo??-o-BBMoMEE-B-o----EM-M--E-?-----M-?M--o??BM-BBM--Mo--?M-?-oMoB-MB--B---M--Bo--?--MM---EB-B------BM--oM-?M--??o---??B---BM--BBE--M-Mo??ooo?--o-M-?-Mo-o--M?o-MB-oo
oo?-?o--M-Eo-M-EM-?ooB--E-Bo--oo-E--E--?Bo--M-MoMoM?------o-M------o----???E-MBM-oE-o-------oBM?--?-oB-BE-oMEEBM?-o?-??M-MEoB-o-oMoBo-?o-B-B?---oB--MBo--oBE-ME---M-M-o-???-M-Boo-o?B--o---?-o-B-?--M-oo
-B?E-B-Bo---MB-B--E--o--Mo?E-B--EM-EME----o-M?BoBo-B-?M----o--BoBME-o-Eo?-E?E-o-B-?--Bo?--M-oE?BB-?-B--o?--B-MoooE?E--o----?-B--o--??-o?oM?oEoMEM?-E-E-Eo--?-??-EooB-oMMBo-EM?BooBB-EEM?MM-EE-M?BB-Movoo
-B---MM--?M--o-B--B-?ooEMM--o-Bo-----M---E-?M-oB-oo----Moo-?Mo-B-o-Mo----?B-o?-oE-o-oEEoB??-??ooMoEBBMM-B-B---M--?-?B--M-?E----BoEo-o?--o-B??-EBo--M--MBMo-Bo?-o--oM-?-MMBM?B-Mo?-o--M--M?-M?oB---o-Efoo
-MB?--B?B-?-?-M-B?---ooM-Mo-?MBMMMB--oBo???o---o-o--o?o----E?---E-oo??o---oE-?B-?M-BM?M?-ooo-EoM?MBBEoE?Eo?-Eo---M-M-E--o?B-?-oB---BBB-?--?-B-M-M-----B---o---oEM-?--BMEB--?M-MBB?B?o-oE-?-o-o---MBo?foo
---M-M-o-MEMB--B-?-EEo---?----BM-o-o---oo?E-oo?M-B--Bo-MoM-B------B--oM----B--B?-oM?---oBooM-MooBB--?M-B?BM-?E-BM?oMM?ooM-o?-?EB-ooME-oM-o---E--?o-?---EM-oo--EMB---?---BEMBBoEo?-BBBM--M-EoEoE-B-o??foo
o--?-MB-BoM-------oBM-E-o?-?E-Mo-----oEoEoMEo?--?M---?oM?-MB--E---Eoo------o---?-??oMoo-oM-E?M?E--?----oBBE-----B-?--???E-EM---MMM-?B?-B-?-B------oBoMB?-B-Bo---o-Mo----EB-?MMB-B-?MBo-E?M-E--Bo-BE?ofoo
Bo-o?-oB?MM-E?----E??BMB?---?-??--EM-BB---o-M-o-?-oM?--oooEE-BMo-M-MMo--o-Bo-M--B?BM-M-M--?-?-?-ooBoo--Bo-?M-M?-?--MB-MoM-Bo-E?---?oBMB?----?-BMM-?MM-----BE---B--EMMBo---EoM--o--?-B-o-o---?-B?ME-M-foo
---MTo-B-------?--M?-MBB--MoBMBBo-?--?---T---o----?-?Mo-T-B--BTT--MBoBTo-M?--oT--oM?o--?M-M----MM----o-?-E?o---oM-o?ooTE-?BoEBTT-ooM?oBoTo?BB-o?---M-?M--o-T----o?M-oT---o?--M?ET--o?----To--Bo?M?-Tofoo
mBB-|-o-E-M-BMMBEoB---o-M-?MBE-?B-EEBoo?-|B?--?B-EEBoM-B|ooo?M||-?o---|oo?EE-?|---o---ooM?B-BM-------BMBEBoo-E---oo---|B-??Boo||-?EM?MoB|?o-E?MM-oEM--M?o-B|EM-?-BBEM|oBM--?-EM-|oo-EMo-E|?M?EoBE-?|Bfoo
XXXXXXXXXXXXXXXXXXXXXXXXXXXXXXXXXXXXXXXXXXXXXXXXXXXXXXXXXXXXXXXXXXXXXXXXXXXXXXXXXXXXXXXXXXXXXX-----XXXXXXXXXXX---XXXXXXXXXXXXXXXXXXXXXXXXXXXXXXXXXXXXXXXXXXXXXXXXXXXXXXXXXXXXXXXXXXXXXXXXXXXXXXXXXXXXfXX
