-oM----?E-MB--M-B-M-MM?----oE-M-o?E?--?B?--o--o?M-oE--EoE?E----o?-B?B------oB-o--?---B-B-----E?-o--?-o?-o--M--B-B-o-----o-?B-M-----?--o---?-Bo?BBEE?o--MB??----B-----MEM-o----------B--E-?-BBM--BM-E--oo
BE-o--o-?B?oo---o-----?BM--MB--Mo-?--??o--EEo-o-?----M-MM-B-oo?Bo---EB-oE?--MM---MoM----EE--?BEBBo--o---oBM?M-E?B-------E-M--?----E---?-?Bo?o-MBM-?MM-BoM---EB-BMM?-?-M-EoM------Eo--?M--Eo--B-?-BM---oo
BM--oM--?--B---oo---oBE-EBMo?o-------M--oo-----??M-ME--o-o-?-M---BB-ME?-M---ooM-E--M-B-?B--ooBM----?--o-B---M-?oBBMEoBEM?o-B?-?-EBB-BMB----M--M-M-EMMMo-o?---EE-MB-EoE--M?-MMoB--B-?---?MM?-o--M---BM-oo
---M-??---o-BB-o----MMBEB-MB?M-B?EoM?o-?o?-?M?-BM--MBM?MEB------BMM-MB--M-??Eo--B?----MoE-o-B-o---oE-o--------M?---BE-BBBB-----MBo--??Bo-BBE-oE--oB-oM-------B---M-M--E-E?-------M--B-o-M-E-B?M---o-B-oo
BMM--M--?-BM?oME-BM----?-oEo-o-M--------Bo--oM?-oMo-M?EoM?o-oE-o---M--E---?-?--M?E?oBMo-?-M-BM?o--o----?EMEo?E-M?M-M?-B--oE?oB---MoB-MM----M--M-?EEM-?--o-BB-E-o--?o-------B--E---MB-EM-B-B?-oE---o---oo
EEo----EB-----B?-Bo??E-----M-B---E??-EMB?E---MMo-??oo-?M-M---M---o----?-MEB---M??M--B-oMM----??oo-M-Eo?-ME-E--M-M-o--?--?B--oo?ME-E-o----?BEMBM-??-M-?B-----------ME-E??M??B-B-M---?-B?-BoBEMMB--o?oo-oo
-Mo--M?-----BE------E--MMB-M-B-B--MMB?-E-?---?--------B------?-oM-o------MBE-oo?B-?-B-Mo?--BB-Mo-o--B-oB-M--M---M-M-M---M?o-B-B--?-o-?----MM?--Moo-EoM-?----?--B?-EMo--o-M-o-B?-----?M-o---?-oEoo--B--oo
B--BB-oo-o---?-----EB-EB-MEBo-B-oM---M-B---?BEEo-EM-E-Mo-oME--o-?B--M-?-E-MBBEo-o-BB--B-E----B---MBMM--?---oEE-?---o---M-oM-MM-?-BBoBMME-BE--o-Bo----E-M?-?EE?MoMo-Bo?o-?MB-?---?--oB?B--?-B--?M--o--voo
Bo----EoBM------oE-M--MoEoM-??---oM-M?----MBo----?--M---B-----E??M--?--?-----MBB--?--M-M--BBEM----?o----o?o--M-B-MM-BoM?--M-?--o--ooM?------EoM-oo-o----?---B----Eoo-o-EooEM-?oB-oMB--BE-?E-oE?-M--o-foo
-?M-o?----E---?E--o-M-B--BM-MM?EEBE-MMB-E-B-M-oo-o-BoM---ME-oM?--M----?o----EE?B-M--o--E-BM-MB----o-??-E??---------Bo---EB?M?o---M----o----MM--?--?--?MoMEB---MM?-EM--M?----MEME-?B-o--ME--oo-oEo-M--foo
--B?MEMMo-?--E-?----?oM?Bo----M-?oM?B?---?-M-M---oMM------MMMMB-??E--MM--E?-B-?oo--BE-EBM--o------??-??------B-?--ooB?Mo-MB?MMM---oB?-?ME--o-?E-?EE---BB-BoB-???-M?M-o-MM--M-MM--M--BBo----M-o-?Moo--foo
BM-o-M-??----?-BM---MBMM?B-?BMoo-o-M--o-E----BM---?--EM---B-Eo-oB-ME-BM--?-M?B--B--?--B---oB----?BE?-M?o-??BMoB?M---?--B-B-B-B--?o-oM-MoM--M--?BE--BBMoM-M?--BB?--?oo??-?----oB--------?--?-?--???EB-foo
-MMEEM-o-?o----B--To?--M--BM-o?oM-Eo--Eo---BoM-M???----oM---B-BTB-M-E-o-Bo-MBM?EB---?-oB---o---o-E-?T--?-oM??oB-oB-?-M--o-B--?--o-???--M----?--o-?-?o-?T-?B-EB---?------oo---?-o--o--o-----?MM-o-B?--foo
-?BTT--?--oBMTo-ET|-BT?-oTTTB--To-M---TB-Mo-----oM--BT--?-?oT--|--??-B-?M-EB?o?-o----E--MEBMB?MMMBE-|---?ME-o------oE?TT--BT---?M--M?-E--oTE--B----E?Eo|-Boo-B-?B-E--T---oB--o?BE?-o------oM-M---BM-Mfoo
m-M||EooE-M--|B-?||--|??E|||oBB|-o?--M|MB-oMo----BB?B|-B??M-|-E|BoBMM-BEE?M-oBo?EMEEM?--?BMM-MEE?oMo|M??o?--?-o?---EB-||?-?|E----?E-M-M-oE|?--?----?--?|--o-B-EE-E??o|?-M?o--oMEMEo-o--MEoB-oBB?ME-EBfoo
XXXXXXXXXXXXXXXXXXXXXXXXXXXXXXXXXXXXXXXXXXXXXXXXXXXXXXXXXXXXXXXXXXXXXXXXXXXXXXXXXXXXXXXXXXXXXXXXXXXXXXXXXXXXXXXXXXXXXXXXXXXXXXXXXXXXXXXXXXXXXXXXXXXXXXXXXXXXXXXXXXXXXXXXXXXXXXXXXXXXXXXXXXXXXXXXXXXXXfXX
