BEE-BMM-----Eo--Eo-oo--B--?-o?E--B?EMB---o?-E-oB--Mo?--BBM-----E---o--?--?---?M?---?M----E---?-M-E?--M-o-?-?BoB?--B--oE-E-M-EMM---???BM-M--oB-EE?----M-MM-EMMME----?B-MBoo-----B?M---Eoo-B----oB-o----oo
---oEB-?-o-BM----MM-oB----MooB-o---BB?M---M---oo-EBM-B---?E--BM-?---oM---BB-MoB-Mo--M-B-?--MM---??-----E-E-o?-Mo-B-BM?-BMM---M?---B-oB--EE--M-M--ooB--M--oMBMo?B-o---B-oM--?M---o--?-M?---?o?oEMEEoo--oo
-M--BME-o-o-?-MB-??---BM?-------o-BM-oo--BM----EEMM--oM-?E------o-?---o--?M-?--B?oBMBB-o-MB-M-o-o?BoM----M--Bo-M-o-M----BMM-M--?o---B---M?E-?BM?B-?----o--BoBMoB-M-MEBE?-B---oEo-ooo--B-?oB-B--M??--o-oo
B-?oBE--o--MMM--?---MMMo-Eo?-o-o-?-M-B--Mo-?-M-?-B--B?E-oB--BBB----BB-MB-?oM-?-?o-B-E-E-?--M?E-B----?---E--o------M---oM?--?Bo---M--B-ME----M-----Mo---?---o--MBoME-M-B----?--BB---B-M--B-?--?E?B?--B-oo
-oo-MB-o--o-EE-BM-B---B--B-B-M--?----Eo-MM-B-oo?----??--oBo---?Bo-ME--?BM-?o--o-B-M--B------?-o--o--o---B--BoMo-E---M--??--M------?---M--B?o?-E----MB-E---EB---?--B-BBB-?-MM---?M-BEo-E?-----?-B--o---oo
Eo-o--MMMEE--Moo--M-Boo-EE---?---B--M-B--oE-----E-B-BM-oM-MB--?BM-B-B-?E-?BM-?-B?--?--ooBB?-oo-M?------M---E---BBM-B?BEBo-M--?----M-BB--oo-M----?-----?-----M?--oM-?M--MBMM-?-EE---BEM?-BM--??---M--o-oo
M----ME-EM-Eoo--?-o--MB?BM-oM--M-BEB-oo--o-B---M-M-?Moo?--o?MooB?--M-Eo?E-?oBE?M?-MEBo-----?---EMo-?-oM-M-M??o-B---oBB?B-----E---?----o--M?-?o-MMoBE??-EBMM-M?-M--M-----MoB------BooME----o-BMB---B-M-oo
--EB--B-MEB--?-M?-M---B---?-M?MM-o??M?M-o-BoB--?---?M-?-?--Bo-?-B--M---?M-EMEB?oE--MMooo-----?-?oBBME--o-o---?BBM?-oM-?B---?-?oMo-B------o?--B-MEMo??B------M-BoooBB---o?-M-oEo----M--M--o--BoM---M-?voo
E?MoME-Mo---EMo?-Bo-M-B--E---MB-BEMo?Mo-?-M?----?-?-o-M-o-E---EB-MoM--E------?-?B---BM--B-M---o--Eo-M-EMB-----BBo-oE-??--?o?o---?--MM-MM---B--?----M-MMM---E--M-EE-M-B?E-oM--M--o-?o--M-o?M-o?-oE-EoBfoo
BB--BB-oo-BMM-BE----EMMB--oo?---??E-BBMM---?-M----o--EB?-EMM??Boo-----??E?-o-ME-oEE--B---?MMMMoM?-o-M-ME-BBo---o-?MM?B----o?oM--oE--?--M--o--ME---oMM--B--BME--M---Mooo---M----ooo---?Moo---?--??-M--foo
-o---B---EMo?B?B-MEo-oM-MB--MB-MBBME-Mo--o--E--B---MBM------?---?-?EE---MB-----E-BB-oM?o---MoEMM----BM-?BM?B----ME??----?--o--oB-B-ooo--BMB-MMM-?--M-------B-B----B-BE----B-o-M-------??----o----MMM-foo
?-o--oM?-BoB----BBM---B-o-M-B-MEoMBM-MBE?-o-?---o-----B------B-M-B-M?-MoEMM---?M--B--MM-MMM---o--?MMBE-?M?--??B-B?-M?-----oo--B-------o?-?B-oo--EM-?-o--o--B--M--EBM-M-o-M-M-o-E-o-o---BMM?------M?BBfoo
-BE?o------oT--o-TMoB--?T-BMMooBBMBM?B?----E--o-?----Mo-M-E-B-------?-?---ooM--oE----?---B-E??B-?-?--B-oBB-M-BBEB-o--E--T--B?-oE?-M?BT--B--M?B--M-BB---B-BB-BB--B-MM--Bo----o?o-EMM--B-o--M-----B-o-ofoo
-T-B-oM--M-E|o-Eo|B-----|---BoBo-BBT-o--M-oBMEET-ME-E-BoT--T-o--o--T-MEBoTEEB---MMT-M?-E-M-T-M-T-E-o?T-?o?-B-Bo-BMB---?T|BBM--MTT--B-|---o-B-?--T--B----B-----B-?MBB----T?--B--o--?-oTMBMoMo--B--?-MBfoo
m|MoB-o-?--M|MM-?|--EM-o|-o-E-M?---|---ooB-BoB-|?M?M?B-o|B-|oB--oE?|E-B?-|BBMM-Boo|?o-BM---|EE-|o-BBE|?--BEoM?M?-EoB-o-||E---M-||--MM|E??---EB-?|---M??oBBo-BE---BM?EEEo|EBMBEMBoo?-o|EoMB-E--o--MM--foo
XXXXXXXXXXXXXXXXXXXXXXXXXXXXXXXXXXXXXXXXXXXXXXXXXXXXXXXXXXXXXXXXXXXXXXXXXXXXXXXXXXXXXXXXXXXXXXXXXXXXXXXXXXXXXXXXXXXXXXXXXXXXXXXXXXXXXXXXXXXXXXXXXXXXXXXXXXXXXXXXXXXXXXXXXXXXXXXXXXXXXXXXXXXXXXXXXXXXXfXX
