?o-oEo-M--o-BBBo--?---?----M?E---ME--MBB-MEo--M-----E--B--o??-----Bo-Bo----MM----M-Bo---??o-o-M--?B-?E-oo-MM-----BM?M?----o?-M---B--oE?B--?oBE-?E--------o--o-M-MMoBo----E-o-o?BoMBMo---B---EBB--oB-B-oo
E-o-MMEMoo-M-?BM?-?----o?o?B-M---BM?B-----M---MB--M-M-BM?oB--o-M?---E?o-Bo----o--?-o--B?-B--o?---?-EoM-?M?--Mo--o---EM-EM??oM-oMMBBE----o?B-----B?M---?oo----BB---M-??M-o??--B-BoM-B?-----EE?-M-------oo
?-E?---BB--ooMMM--M--MEM?M-oM----oBoB-o-B???o---M??-EoB--o?---BM?MBo-E--BBo?-MoMM--E---oB-o?oo-?--E------E-?B-B------BE-o------E?-?---?--?o-EM-oE--BoMo--o?-BM--M-?Eo-?--?------?-M--E--?oB--E-BoE-B--oo
---M----o-E??-B-MEMM?M-M-o---E??--M--o--E-B-Bo-BooB----??EB-M-??-EBB-MMo-MMB--Boo?--BM---?o--?BE-?B-BEE-B?o-MB---Eo--M-BE----ooMM--E-EB----B---?M?EoM?-ME-----Mo-M-Mo---BE--Bo-EEE-??---?-B-oM-M-BB?o-oo
-B---?----?Boo?-?--?---??-M-EMB---?----B?-BEE?M-BM-M-B-BB?M-M--?--B-o-?ooM?-M--BB-E-?-B-E-oB--E?--BB-M-o--o??EE?o--ME?--B---EM---?-Bo-B----EMMo---M-BM---MME--E-----E--M--o-B-B-BMB--M-BMoBE--?M-o--?-oo
E-?B--E--o-?o-B-o--BE?BoE?--B-M--oB-oB-E?--M---MME?o-?M--B--M-?-E-MB--?M-oB------E?M----?-M-?-BB-?M-B---?B-EB---EM-BM-?Bo---BMB-M?---?E---??-M-B-B-B---MM-BM-MBMBB--B-B--o---o----oM------BMB---oB--B-oo
M---Mo--Eo?-?-oM-oBo--o---oo??MEM---M------o--?B-?M-?--B-M---oE-ME--?BME---oo-E-M--?M?-E?-B-o?--oM-B?--EB--B-o-?ME-B-o-B--MB---B?BB-E--Bo?M-BM?----E-E---o---M??E-o?oM-E-B?MMMo--E-oM-o----B-M--B-----oo
--M-M?-MB-M?-o?--oBE-o---M--EMEME-o----M--?----B---M--EM--?-E-?-M?oo-EBMBo----B--M?MEMoMBB?o--B---MM--?----Mo----??---oM----BE?-o--B--M-o?---o?o-----?----EB-o-----o-oB?B--Mo-?--B---??-?-----o-M---Mvoo
-oBE--B-------?-o----B-----o?-?-?--o-?-?-B----EE-oMB-B-----?-EBoBBB-MM?---BE-MB--B--??MBoo-o---M-----M-M--?oE-?--?--BEooM-o-BMBo---?--MB?----M----M--MEBE--M-M--B--M-?-?----MMM---ME-BEo-----?-??-?--foo
--?M-ooBE--ME-BB-oE-M?---?-----M?BB-----o----?MB--oo-?-M--?-B-M-EEEM-B-B--?-oMM---Eo-M-B---?M-?-BB-B---??MM--o--EM--B---oMB---Eo?EE??-B-EBoo-EEBoB-o--M-?M-E--?BB-MB?--MB?-Mo?--EB-MMo-M--B--o--EB---foo
BB---?M-?o--??--o-?Moo-B-B-BBBMEEE-oM-E-------M?BMoE?M??----M--oM-?EoM-ooMM?--oo?-M--o-oM---o--E?M?--?-B---M-o?MMB-M--oo----EoB-oBMB--MoBBBoE??MM--oBo---M-MB---Mo-M------o-oo-o?-MoM?---EE-BBM-?E---foo
BB-?-o-BoBE--E-E-MB--M--ooo-?MBBM-MoBM?B--?---E--o?BBE-?MB?--o---?-MBoM?oBoEo-?B-o---??-o-?-o---------------?oo-EB-?E-----T-MM----MEo?BB--E-MB-B--B-oM??-?--E-??MBo--??BM-BoEE-EB---o?Bo-BM--oooEM---foo
??o--B--o?BE-?oM-BE-oB----EMT--?B----M??-B-M--M---o-B-?BooBo------?-??--MB?M--M-BE-Mo-B--E-o-M?-EoB---?o---oE---M--???E-M-|E-M?M-o----M-?---?-B?-----MMB-oM?-----M----o---M--?-Mo?--MToM-B------B-o--foo
B?MoB-MMTBMM-?----?-E----E--|?-B-ooT-ooBoEBB-MoTooT----oo?BBT-T-EMo---TMTMT?T--BE?BoE---o--M-o--?-Eo-M-----M---BoEM-MoBBEB|Boo--o-oTo-ToM-o-BM-ET-oM-oMB?T?E--ETEToT-o--M?---MB--E--T|M--BT---BT--o?-foo
mM--B-MM|MEoo?EB-E-?-Eo-BB-E|M--?-B|o--oEBE-MM?|o-|M-oB?M--M|-|MMMB?-B|-|B|-|B-o?-?-ME?-MM----oooM-?E?-EMM?B-E-???-o?---BE|?o-oM??-|o-|?o?o---MM|-o-???--|--ME?|B|E|?o-oMBBE--BE-?oE||B-BM|EM?-|-E?-?foo
XXXXXXXXXXXXXXXXXXXXXXXXXXXXXXXXXXXXXXXXXXXXXXXXXXXXXXXXXXXXXXXXXXXXXXXXXXXXXXXXXXXXXXXXXXXXXXXXXXXXXXXXXXXXXXXXXXXXXXXXXXXXXXXXXXXXXXXXXXXXXXXXXXXXXXXXXXXXXXXXXXXXXXXXXXXXXXXXXXXXXXXXXXXXXXXXXXXXXfXX
