Mo-oM--MBo-M---B-M-M-oM--EMMB?-o---B---M--MB--B?-M-o--M--B-?-?-M-o--oEBM?-B-MBBMB----MBo----B--B-ME--o?-?---o----BB-M?---M-EM?o-o?-?M-EBo------oM-M-o---M----B-o-oo-BBB?-?M-Eo-M--M-BE-B---M--?M------oo
-oB-?--?o----?-MBB--BEo?---Bo-ooo-----oB?-?---E-oo-o-EB-B??B--?MEE-Mo?-MMB?-oBBMo?--oo?------E----?--o-o--o-B?MMoBoBBE-?-----M---oo-M-?-o--B--EMMM---MM-B?BEo?-o-EMo---B-oo--B?BE?-?----MMBB--MBBE-?M-oo
---BB-BEM----?oB-??EB--M?-?-o----?oEB-BM-B----M----E-B-oB?B---MMMB-MB?B-o--B--E-----BBM---M-B--?M--?-MBBoo-?--?-o-B--?E--oE-M-E-?EBB---?---B--BM?--ooB----MMo----MBo-MB-B-MM-Mo-B---o---?---E-?Mo--?E-oo
--o--B-?oBB-o--oM--MM?BM---E-MoEo--?-B?-E----MB-B-BB-?-----E--o-?-oo-o?-o-EM?B--------o-oE?B-oEo?-?-?B?-BM-o---o?-M---Bo-B?---?---M-o-----ME???o-?M?----Bo-MMBE--B-B-?----BB--E--oBo--o-?M--MBE--B--B-oo
?-B-M-BMB---o---?-M--?-BBEBM-M-??--EM--oMo----MoM?M-EB----??-o?-E--MoE-oB---?--MM----E-o?-B--oMB?B---?B?MMB---o-B-E?-o---?oo?M--M--E-o--M--B?M--o----MEMo--MBoBMBBE----oEB?--M-MMB-o-o?---BoBM?BB-B?--oo
oMM----BMBM-MBB-M-------MB---M--Eo-?M?E---Bo-M----o-M-?B???BB-E?--MM--oM--EBEoM-BB-M??oB??o------?-MB--MEEMo?-M-?M???-B-E---E?M-MoE--B-EME---E?-B?o-M?M?M-E-o---oMB-o--?M?--M-Mo-M---EE-B?B---BM-o-oM-oo
---B-?M---MMM----B-o--B-M?-o?---B-B-Mo---MoME-BEB?-----M-E-?-BM-----?B--E-B-B-B-E-?-MM-oooM---B-oB--B-B--?-B--EM?----M?MB-----?-BM----MM-M?----ooo-oB-EM--M--?Eo-B-?--o-BB?---EMMEE-?M---Eo-?oB---?-o-oo
?BMEo-BMoEM-?-E-EEBB-MM--?B--Bo--E?E--MB-B?-?-MM--o??o---MEM-o-o-?-E?oM-M------M-M---E?--B?MooMo--?---ooMo?oMEM-?-E--?-MMo-B?M--MB?o---o---o?---B-B-oE-B--?---?Mo-EB-ooBEoBM-o-M-?M-BoE-EM--MEM-?oM-ovoo
?--??-M---EM--MM?ME-M-oo-?-EoE-?--?--E?E--o-M-?EM-BoBo?-?--?o?oM-oB-ME-?----M--?-?o--?M--M-M?M-o---M--Bo----?--BM-B-?---B-M?M-MM-B-B--E?-B-M--M?--?-EME--MEM----?-?-E--E-EB--E?-MB-----??o--MM?-?oB--foo
oBBo-BB-??-M-EM-o-MB--BM-B-Mo--B-o-B?B-?o-EEE--B---MB-----Mo-B?oE-E----?-?-??ooB?-MooM-o-?B-o--M-EE-o-EMBB-----o--ME---B-M-BE----BB--o-o--EBME--?B-oM------?----B-B---B---oB-?-----o--M--B-Eoo-EMMB--foo
o-o-?B-E-BoM-B?Boo?-?EBM?-B-oM-B------B-?-B-BoE-o-B??M-?--?oB-B--B-M--B--E--o?B-B-B?--M-BM--?-Mo-B-M--M-oMBM?--EE?--MM-Eo-o--M-oMMB-B-MoMMM--B--?-M--EM--M?o--?oo-M?-------BBo-B--M-oB-B----MM-?EoE-?foo
-BB-o--B??--M-M??---oB--BMB----o-o-M----o---E--?B-MB-oo?--MBoB-?----E-M----M----?-E---B?------B?-?----M--?-?Bo??-Mo-B?--??---?-EE-M---E-M-oo--M-BE-BEBBB-M-B-MMM?---M---o-M----?oME----BMMB-MoEEM-?-ofoo
B-M--?-?--o--?--?-o?M--?M-?oMM--?-MM?----MBEM--?oM-E-T-M---M--?o----?-M-?-oo--M--BM-o-?---?E-M?MM-o-M?-B?Boo-o--MM----??----?---BB----?-?M?-o-oE?---B-B---M?o-B-B---?---Mo?Bo-???-B-o-oBM-?-?EB--M---foo
?Mo---BME??-?---TT??----TMBoM-Bo--T--MBooM-B?-o-EEE-T|T-?T-B------o?oTMB-?M-?M?M--oM-o-o-?T?M-?-?E-EM-M-M---o--o--E-?-----T-?T-TM---o-?-?T-B---?--E-oB-B-?T--?T-BoooBBB-M---E--ME-B--Mo--MoMTM?B-o-M-foo
m--?-EB?M-BM-?B-||ME---B|Mo-B?o?-B|o-----o-BE---?BME|||ME|??-E?-E-E?-|BB-BB--?oM??B-M-B--?|MM--?o-BB-B?M?EMoo-MBo--E-EooME|-o|E|?oE--BEo?|-B-M-?-M-oB-M---|Mo-|--?---MB-?-EMBEE---E---?o??Eo|-?-?Eo-Efoo
XXXXXXXXXXXXXXXXXXXXXXXXXXXXXXXXXXXXXXXXXXXXXXXXXXXXXXXXXXXXXXXXXXXXXXXXXXXXXXXXXXXXXXXXXXXXXXXXXXXXXXXXXXXXXXXXXXXXXXXXXXXXXXXXXXXXXXXXXXXXXXXXXXXXXXXXXXXXXXXXXXXXXXXXXXXXXXXXXXXXXXXXXXXXXXXXXXXXXfXX
