B?-BoB---?B-?B--oo-----?-----E--???----B--Eo--?E--MM-M--o----B-EB---o-B-M-?oMo-M-B--?oM-o---oM--o-B?o------o-?M--?--o--M-o----Bo-------B-----BBBMB--?----oE-M-B?-MooBo--ME?---EoE-?BBo?-M--EM-o-M-?M--oo
-o-MM?--B-B?o-M--BM---B?--o-----MBBM--MM-o---M---?ME-?-E--BE-E------EMM--M-B----Bo?oM?-?E------B-oME-EM-?o-Eo-oM-?BEooBM-BB-M?E?-Mo?-ME-Mo--o----E--Mo-EBMBE-o-BM-----?-oBM-o-MB-o-E-o?-?------B--E-o-oo
oM?B-E?----?------M-o-------E-o-?o--E---E--?B---o?--E??M--?B-M-?o--?----M-E---Mo-B?Bo-o-B---oEoB-?B?----M-?B-------M-B----M----B----B?----E--?--?Boo??--o---?---B-ooo-oMBo?E?ooo-M-Bo-MM-?o--o--o-M---oo
-EMoMME??-B----??o--B-o-BMoB-B-oo-B-MB--M---o-B-B--M-??-M------M-MMB--E-?--??EB-MB--?o-?o--M-B-M--B-?oE??---E-E-BM-------o----M--?-o-BB-o-?BM---?M--oBE--o-B--BEEo--M--?-o---M--B-E-B-oo?-MEBo?-B--oB-oo
??M-oBB?B--o--B?--EB-B--M-B---MB-E----MBM-?E--EMMM?B---M-oo--?-----BM-Boo---??-oEMB---MM-B---EoBMME---?-B-??M--o-M--MBoME-B--oB--o--E-o?--BMB--E-oEoM-??--?-B--B-M--B?-?oMMMo??-M--o-ME-B?MBMMMM?--ME-oo
--?--Boo?Mo---Mo???---EBo-B?--MB-BMBM-EE--oM-BB-?---o-MoMM--BEE-E-?--oM-MBMBMoEo-o?--B-o-----BB?---M---E-B--M-BoB--o--EB-E---?B--M-EB----oB-?--MBE--oBEE-oBBB-??oBo-B-ME?-E-oM----MoM--M--oBB--?-E--B-oo
E-----B?MoM-oo?o----BMB?B----Mo--oMM-o?--E-o-?E----o----B---o-MoB-B-o-M-o-?Mo-?-E------?-EM-?---?--------Mo-o-ooB-B--BM--?----MoM--B---M-------MEM---?--oEo-M--?M-Bo---?-BMM---M----M----M--?--?M-ME?-oo
M?-oMMoE??MM-?MooB--?--Eo---?E-oME-E--M-?M?-Mo?--EBB-M?---Eo---o??o?-oo-o-M--M-o?E--Mo-BM----Eo?M--?o---M-?---EMo?-oB--oM------M---E-M--E----o-B?-M-E---M-o-M-E-MMMo-?oo-?o-?-EMo-?---o-B??BBoMB--MB-voo
B---o-?B--Bo---o----o-o--o--E?B---MM-BB--o?B?E-E-B--o-----M?o-o----B---B-oBE-?-M----M----?--o--B???EB--EB-B--o---M-E?ooo--??M----oMBo-o-M----Eo-M-?-B--oB?-EM--?-M????M---?---?-?M-?-MB----BM--Mo----foo
-?o--BMBE----B-o?---o-M--MB??-BBo---ME-EoM-?BMMB-------BM-BBM?---Bo-----o?-M?-M--ooo-oMB-??--EMoMo-MEo--BE-oBM?-Eoo----MBBB-M-B?M--E-EoB-EMB-MBoM---?o-o-oBM-B---E-?-M-M-M---BM-----B??---?M----oMB-Efoo
-?MMoB-EBBBo-B-E?o-M----Eo---BBE--?B-B-M?-o--M-?------EEB?M-MMMMBBBo-BMo?-BMM-BB--Bo---ME---EM---B------?B------?--B-B-???--Bo-?MME-MM-?o--M--oB--o?---M---?-?M-B----M----EMEEoM?--MEoM-E---MB-M-M-o-foo
M-?-----?-M-B-??--B-o--o--?--BB?---?---B?--Mo---MME-MB?---BB-?M?o-o---M-o-??-B?---oB--B?-M-B-??---o-o?-EM?B?-MMB--??-BMoEB--oBMMBMBo-o-?--B--BEBBB-?-ooBMB-oE-M-T---BMMM-BB-?--EE--E?---Bo--M??---oB-foo
--?BE--Bo??o-o-?ME-BB-B-B---o-----Eo?---BB-M?M-E-?M?-?-EBB-B-B--o---??-?--MB--BoM-?--?-------?---B-o--o--?--BMB--Moooo-oMB---ooo-Bo---M-M-M--B--?--B--M--M-o-?B?|--o-B-oBB--?--BB--??-Mo?B-M-B-E-----foo
-o?--?o?M?-?-E??T---B-MoBMo-o-oo--?-T-oMB-E----M-TMEMooT-T--MB-?-?EBoBoBB-o?B-M-To----T?-E---EM--oo-----?BMB?BB?-?B--ME?-----M?--E-BE--o-E-EoBBT?-?M-BT--?T-??T-|E------BTE-M--BEB-T-B--B-M-EoB?----Mfoo
mB-B-oE--MMo-?MM|B-?EMM-?-Eo--E-E--E|--oB--EEB--o|oM-??|M|B??--o-?-EE-?-M-M-EM--|?M-?B|-o?EoEB---MBo-EBE-?--Eo?---o?oM-?E-oBooEE--oo-BE--?M??EE|?o?E?E|oBo|-BM|-|-M-EME??|-?E?oEM--|EM-M-B-----MMEEB-foo
XXXXXXXXXXXXXXXXXXXXXXXXXXXXXXXXXXXXXXXXXXXXXXXXXXXXXXXXXXXXXXXXXXXXXXXXXXXXXXXXXXXXXXXXXXXXXXXXXXXXXXXXXXXXXXXXXXXXXXXXXXXXXXXXXXXXXXXXXXXXXXXXXXXXXXXXXXXXXXXXXXXXXXXXXXXXXXXXXXXXXXXXXXXXXXXXXXXXXfXX
