-??BM---oEB?E-Eo-?-M-----EoM?-BoE?EM-M?o--?EMo?M?-B---E--MEM--MB?B-o--o?BE-----?---?-------E-??B-?-E---M-o---ME---o-EoE--B?BM----M-??--?B---Mo-?B--Bo-o-?o--oM--MoEB-MB-oBEM?o-E--o----oE----o--------oo
oMMMM--oMB-----M-BB?-MM--?o---oB?o?-E-B?oB-?-o-M-?-MBB?M---MEoM-?o-------?----E-?---BB-EB--B-B-o---ME--o-E?oMo?-M?--?EBB----?-??MB?-?o?E-?o---MEMoB-?---o-----------?--?-?--?BM-E-MBEB-MB-??MB-o?--?B-oo
------o--B-B?-----o?-MMBMM-o-?-?-MB-M--E----???MoEo---oo-o--BoM---B--M-EE--?B-?-o--E-B?MM--B?--E--BB-oB-MB--oM-o-B------EM-EM----Eo-M?BBo-B---o?-E-E---oM--M--ooBM---B-M--M-Mo-M---EM--MMooEB-o--o--M-oo
-?-o-BME--o-BB----BEEM---?-MM-EB--M--?-M---?--?B--BMoB-MBM??-M-M--M-M--BMB-o---oB?M?---M?M-M--MBMo?oB---M??B--BoB--oB-?-?--MoE-E---M--MM--M-BM-o--oMo-o-o?MMBB-?-?-E----Mo-ME----o--E-M-o--B--BMB-EoE-oo
-BM---BBM-M?o--B---?--B-Eoo?-oMoM--M--o--?E?-o---oB--o-BB-?-M?B?---??-B-?-o-B-M----M--o---?--M-oMo--o--o----?B-?B---M----o--oMB--oo--B?---B-E---o----oM-ME?-E----EoBM-M-MBo?---?M---?--B---E-o--M--BB-oo
?MM?--BE-B-?o-B--BE?--?MM----B?----EB-ooM-B-B-B--o-oEMM?M----??---EE?o---BM-oo-BoBoM---?--EE-B-o-M--oB-MBB--o-M--M--?-E----oE-M--BMo-----oB-Mo----oE-?BE-?-E--M-?--?-?-?Mo--??-----o-o-?BE?B-Mo---?-E-oo
--E---?MM-M-o--M--Bo--BEM-oMMooE--o-B--EB-Mo---?--?-?oB--M---o--B-B?EBM--o---B?Eo--MB?-BB-BM-?MMM----E---B-MMM---o--M???-o---?oE-o-?-EBE--o??B?----Mo?-B--B?o---?B-o----??----Bo-o?-o-oM-BEEo--B-B?o?-oo
-MB---MMB-oEMMM--o?-oEoBB--oM-o?-E--MoM-BoM-B---?-?-o-B-E?BE----B-?-B-B---MB-----Mo?o?-??--?MEoEBo-o?MoBo-EMoMo-?-o-??--M---o-M--?BM-Bo-EM-----Bo-oM?B-MB-o?B-----BE?-EE?EBM--B-----oE-E-o--o-----?-?voo
-??o--o--BE?-MMBoBB--?--o?-BE--?---B-EoEo-oM-------E-BoB---B-E--?M--o----o--E-oE?E------o-Eo-M-?E-Bo-M?--??---o-oE--o-Mo---B-oB---M---M----MB??oMMB-M--M-o-M-E-B--BMo-?-?-MM-Bo--oEo-BEMo-o----EoooBMfoo
--?-o-------------BE-------MMo--oB--?-BM--BE----BBoMM--Mo?--M?--o?-E--ooo?--?-?--M---M-??-M----o-?-??-MooM--?--oB-B--o----M--B--o-?--?Eo---?B--M----?M--B-?-o-Eo-?-oo--MM-o???----Moo-M-o-o---??----Efoo
-?-M-oo-MME--?MEE-MB-oo---o-o--B-?--B???-M------M?-ooBMoBB--B-BM-o-?E-------B?o-oM-oE-MoMEMBM---oBoE-?-E?---B---EM--B-BB--B-?o-oB-?--MBEB-M-M-EooB-----oM-o---?--?-M-o--oM--E--EB-B-BE-M--M-M---ooEoBfoo
-Bo--------oo--M-----?--B-o-M---o??M-o?-M-oE-?-ooMM------oBBoo?-?----o---------M-M--B-?------?--MBE?-o-?-EM-MEMBB?o--o--B-----EoM-------?----??--o---E-o?EB-o------MMo-??---MM-M--EoM---B?---Eo---M-?foo
M?o--?BEo-B-oMMM-Mo-o--?M--BM--B-o-Mo-B----B-MBEEoB-E-T?Eo--?-MEoME--M-MBBoM?B-?ME----?E-oB-Bo-E-M--?To-MTB-o-------?----o-o?--Eo---o-BM-MB?---o-E------M---ToB-B-B-B---E--E-ooBMo?BE-o-MM----oE-o-oofoo
M?B----B-B?T-B-----oM?oooTM-MB?-MEB--MT--To?o--TM??M--|MM?TEB--TTTM-TM?-BTM-MBo-?B-o---BM-?E--E?B-?--|o-T|To-T-B-EBo-BEMBBo-T--?EoE-?-?-o?M--B---BT-?--T-B--|M-?-B?o-TT-TB--oToMoTE?B--T-B-----B--?--foo
m??o-EBBM--|M--?M?M-B-Eo-|M-E-B-E---Bo|-?|EBBEM|-oB?BB|--o|M-Mo|||--|B-M-|--BE-ME-E-E-oBoEo-EM--oo-E-|Bo|||--|-MM-??o---BMMM|o-o-EM??MBM-oMEMBE?--|-?B-|-B-B|B---B--M||-|oooE|MEB|B-BMB|M--oM-BEBoMB?foo
XXXXXXXXXXXXXXXXXXXXXXXXXXXXXXXXXXXXXXXXXXXXXXXXXXXXXXXXXXXXXXXXXXXXXXXXXXXXXXXXXXXXXXXXXXXXXXXXXXXXXXXXXXXXXXXXXXXXXXXXXXXXXXXXXXXXXXXXXXXXXXXXXXXXXXXXXXXXXXXXXXXXXXXXXXXXXXXXXXXXXXXXXXXXXXXXXXXXXfXX
