-o-B-?--o-Mo--oMMMooB-oo-Bo--ooM?BMoo--BoB-Bo-B?B-MEB-oMoM-?BB--BM---oo----M---M--?---oB?-----MM-M?-B-B?--MMMoo-oM------oMBB??M-MM--B-M-?-M---BMoB-E-B---?---BMM------BB--?----???BBBME---E?EMBE--o---oo
EBo-o?-M-EBEBM-M-oM-?--?o-MBEM--B----?---B--o-?-oo-B-?-?E-oMM--oMBM--B?B-o--MoEM-B----B-E--B-----o--B---?-o?BBE-----o?--?-Bo-B?--o--B?B-----E----BE-oo----oMM---BB?o---Boo---E-E-Bo-oo?o---E----?M-?--oo
-----??o---MBEo-------EB--B-M-o?oE---M-E-B---o??M?B-MoE--?---?-?-o?--oEBB-B--o-o-BE-----??-Boo-BMM--?E-oB---E??M------Eo?--?M------o--???B--?B-MM--B-E-ooB--E----EMo--o-M?---?-BM--Eo-oo-EoMMo-M---ME-oo
?-o?o-BB-MB-M?---M-B-M?M---?--Bo-?----o?oME-B?-----EM--o-M-M-B-?--o----M--BoMBBBo----oB-?----?--oo?B-Mo-----M--B--ooB-?-oMBoo-B-----M-??B--oB---?---o--oB-B--M?-o-----M-?-oo---B-BMB-o---?BME----?oEB-oo
M-oEB--B-M--M---M-?-M-B---M-?---M---?-B-----o-Mo--BBM?o-o--E-E-MB---o?---?--?E-M-M--?EM-Bo-----?M-o?------Eo?-MoEMB-?---M---E--EoBM-o---B-BBoooM-?M-B--MEM----?--?---M----M--B-?-?B?EBB--B-oBEBo--??B-oo
--?B-E----?BEBM---B----oM?o-M?--BB-o-o-B-B--BEE-?-o--o-o--oMMB--BoE?EMBMB---M-M-B--o?B--MM--?---oM-BE--?--BoM--E?E--?E--?EoBB-E-oo---B?-E-BM?-E----BoM?--M-ooo--o--MoM-E--M-?MBoo?E?-ooM--?E-?-?---o--oo
-oM?-B-oo-B?--o--E--?-B---oo-M?E--B-ME-EMM--?B---E--??-?-M---o---EMo-Mo?o--?MB-?B?------oMB--?oo--MM-M-EM-----MB---EBB-B-B--?o--Bo-B----B--M---E--oE-o-Mo--?M-o---o-E--?-BM?o--o-----?M----?---M?--EB-oo
-o--EM---------?-B-MB----o---o?M-oMBoB---o---E---B--?M--M-E-oE--?MEMo--Bo-EoM-------B---?o-Eo--M-o-MB---EB---------MM-MB---M--M-ooBM?-M?M--o?---Mo?----MB--o------oo?--B----?o?--BM-Moo---MMo?-E--EM-voo
EE???-Eo-M--BB-oEE-Mo?-EoE-o?---o----o?MoEE-o----MoMo--o-E?--M?-?----o--M-?o---ooM-?--o-B--B-B---o--M------oMB-ME--?o-------M-----M----Mo--B--oMoMB-B--BMB-?ooB--M--?---EM-?M-B?E--B-M--E-EoBB------Bfoo
BM-B---?B?-?--M-MB--oM-?o-E--M-?Bo?--B-B--?MMo?E--o---------?-MMMEB-M----BEoMMBMMM--------??-?---EBB?-M-Bo---E--BoE-MM-BooM-?E-oE--oooMo-?-?MEB?o-oE-MBoM----o?M-?----E-BMoo--o--E-BB?-----o?oB?-?-MMfoo
o-M?M?------E-?E-o--oB?E?-?--B----M---EM-----BBM-?---?-M?B---B-EEMMB--???--EM--M-B-o---MB-M-?--M-?o--?-BBE-o----BE?-----MB-?MM-MM-E--??-E--Mo--B--MBMoE-?o-o---MM--BBBM-MB?E-Eo--?-??-E-MoBo?-M----BBfoo
---M?B-o-M------?-oBE--B----o?---?-MB-------Bo--EEE-?-o--?-B?--M---Bo--M-MM-------B-?-??oMBM-M-B?M---oB--?Mo-B---B---ME-?o-B--?oBBMMoE-oB---B--M--E--oME---M-?---ooo-B---oo?--?--B-----?oE--?----o-B-foo
-?M--o---E-M-o-MMB-?-E-MEE--B-E?-M-BT-?oBBoMB?MBM-?oMB-?oM--B--E-TM--o-Eo--E--M-M-B---?M-E---B---oE-E?BEMMB-BMM-oE-?B-?oMBo---?B-MMMoT-BB---M--B-BB-T--B--MB-o-ooB--oB---?-Moo-ME-MoBB-?M-o--T?-oE?--foo
oTo-EE-B-BE--MEB--MM-T--TBM---B-EoME|oM-ooME-TE--M-E-BB-----o-?-?|E?-Bo--ToM-T-M--EoBT----B?-oB?--M-MT-B------oB--TTE-MM-M?-M?-----?T|-ToT-Eo--TBB-E|M-B?--Mo--M-MMMET-M--M-?-ToMT--o-M-MBB-E|-MM-?M-foo
m|---???EB-o-B--MB?-o|-?|--E---MMMB?|??B--BMo|-E--oM-o--?--?EM-o-|?-?-oBE|--E|?-oE--o|B-EBo?----oE---|EE-o---BB--B||?-MM?ooB-ooM--o-||-|?|-MBME|?---|B-M---E-B?-----?|-Bo-E-Mo|oM|?o?M--o---?|BB--?-Efoo
XXXXXXXXXXXXXXXXXXXXXXXXXXXXXXXXXXXXXXXXXXXXXXXXXXXXXXXXXXXXXXXXXXXXXXXXXXXXXXXXXXXXXXXXXXXXXXXXXXXXXXXXXXXXXXXXXXXXXXXXXXXXXXXXXXXXXXXXXXXXXXXXXXXXXXXXXXXXXXXXXXXXXXXXXXXXXXXXXXXXXXXXXXXXXXXXXXXXXfXX
