MMo-o?oBo?oo--M-ooE--BB-B-oM-MM??o---o-o--????o---?MM-MMM?Mo---MB--M??M-M--B?oM-E?M?--oEM---B?-MEE-???-oM?BM--o----B?-?-?--BoEoo-ooE-E---?-?-Mooo-B?B??B-------?-o--?o--Eooo--?oE-o?BoM------o--o-E??-oo
--E--B--oMBoBo-?-EM-BMM--Mooo-oM--Bo-B?ooE--BE-?-Mo?M-???B?--?EB--??-oM-BB-B-Eo?-?B----M?o--oBB?--o-oo-o?B--o?EM----?--?-?-?-?E-o-?-??BB--oo-B---?--oE?BM?EoME-B--o?o-B--?-M-???-o-B--oBoE-MEo-o-B-o?-oo
MoM--ooB-oMo-M--MBM--MoE--MBM--ooBB-?-??oB-?M-?--o-?--o?--o---Mo??-??--?o-?o-M---BB-?ooBE--o---o-BBBoE-E--M--o--???---oMM---oBM--BEMMMo-?E-BoB-M??-BooMo-B--BM-o-o?--oBB-M--o-B--oo--?M?----MMEBM--?--oo
-E----Mo---?o-o--oME-o?BBo--Mo---oBoM----MooMo?MEooo-oooE-BB--?oooB---o--?E-EM---?-B-?--Mooo----?-o??-B--ME??M?-MB----??-??oo?ooEB--ooo-o--?B-B--o-oMMoB-Eo--oo?M---oB-BB-oo--o?-?BBEB-oMEM?-o-o----o-oo
M?---M--BM?-EEM??-??-o?--?---o?B?oMM?o??Eo-B?--oM--B??o-B??----o?oB-o-o?-oM--Bo-M??Bo-o-M-E??o-BBBM-E-oM-----M-?ME?Mo-M---MB?M-EB-oM?oM----BM---ooMEMo-o-B-?E-o--EBEB---B--E---ooooo--?-M?-B-?--?o-oo-oo
M-o???-?-o--??----Bo-------B--E-BB--M-?--o-?oMB-??-ooo----MB-o-BM-BB-o?ooMBBB?-E???M-o-?M-??-Bo-?M---------BM-?--BoMMEB--B--oB-B?B-oBoMo----oM-??oM--ME--B?BB???B--B--?o-oM-B--oM-?M-E?oo-Mo?---EE--?-oo
oo?---E-M-----E-M-?o--?-o-BM--BM--B??-oo----M-MoMoB??BMo-?-M--Mo-?-oM--o--ooMo---?-oMM?B-?---?-MBM-oM--o-?---o--B-M?-ooE--o---B?--?M----E-?-oo---MB--MMo--o-?-M?E--o-?B---Mo-------MM--M-BM?-M?--B-MM-oo
--?MME?Bo?B---?-?-o-?BMoo--B--?-MB?E?M?BE-?-M---Mo??ME--oM-EB-?oB?--M-o?--?--BMB?o--B?oB-E??oo-B-ooM?-E-Mo?B--o-?M?-?o--??oooB-oM---BM-??MM----Eo?o-B-MM-E--M-o-----o-BB?B?E-?-o-E-E-----M--B?o--ooB-voo
ooM-???-BE?-?EoMB--?-o--EE-B-MBoMBo??---BMo-EE?-MMEooM-??-E?-????M-oM--?BB---BoooMo?-BB?--EM--o-E---M??B--Eo?--?--??-oM-??--BBBE----??Bo-?ooB-MB--oo-?--MM??-?----o-?o--EM-?-----BM?-MoB-??o??---E-BBfoo
--BoM-??-?BE-MM-?-ooMMo?--?---EBE--oo-E?E--??---M-Bo-ooM?--ooMBB-?E-E-?oM-E-EBM--?oM----Bo??oBBM---o--oM--B?o-oMB-M-M----?--ME??oMBM-?E?BB---MM-o?M--B?-BM-B--M-Bo?o----M?---o??M?o-EBBB-MB-Eo-B-M-Mofoo
oooo-M-MB--o?o-oM-B---ooMMo-?-?M-?MM---?M--oE-oB-Bo-B-B??-B-??-o-EBM-o??o?M-BooM?-o-E-BE?-Moo?-o-o?-Bo-?o-E?--o-E?Booo-B?E---M?B?oEooB-oB---o?-?--------M----oM??B-EE-BM-M?--Bo-o-o--M---B--??-M?-M-Efoo
?-o?--MEo---M-?-o--B-E---?-?M-EB--oB-?--oMB?-M-oM-Mo--ME-?-o-E?----MEMM-E?BB-M--oM?o-o--M--oE--o??--BooMo-M-E?---B-?-?-Mo-oB----?-?--E-BE-Bo--??MM--BMoM-oBo-B-MMMoM?--M-o?-?-M??M?E?oEoo?M-oMooE-MEBfoo
?------M?Mo-?-?-?Bo--B--E-M-M-?-EBoM-E?EE-o--?--E---MM??ooMB???-E?-?MoMoMoo-?o-?---B---o-?Eoo?oM-B---B--M-?-o-B-B?MBo----?MM--o-----?M?---B-B---E-oMBMBBBM??--o-MB-o??M-oM-E--B----M-MBM?-o---M???o--foo
-E-?EB?---BoMM-Mo?-?oM??-o--?o-?-MM--??-M-E--o?-??---MEoMoMB??--o---o--o--M-E-?B-BB----?oo-M---o-E--B--EB--oM--MB?M??o-------o-----B-?oB?-?-E?-oM?Bo-?E--B--B-?-?--E-?-oo?B-BE??--?o?oo-?--E--?--M-M-foo
m----------------------------------------------------------------------------------------------------------------------------------------------------------------------------------------------------foo
X----------------------------------------------------------------------------------------------------------------------------------------------------------------------------------------------------fXX
