oM?---M--E--?-E--?-B-ME---??-Mo-?-o---?--oo??-E?-?---oM---M---oB-----o--?B-----M?--B?B-B--Bo--MB-BBMMB-o?--B?----?M-M---Bo-o---BB--o-B-BMoE--?---?-M?oBEo-E-B-o-E--B-E??--B-oEooo-B--B-?--?--BBEB-?-o-oo
EM-----oE?---?-MM-??M-Bo------ME------o--?----M--Mo-oBBo--oM-E---EB------Bo-BoE---?E-o---o-o-o-oB-----B-E?-MBo---?oo--BoM-----M-Mo?--??BM?Bo--EBo--?oE--EM-?oo-------??-EB----E-oBB-ME------o-M--Bo---oo
BB-Mo-oM-M---?-B?M-M--EBB---ME--o-M--?-MEEBo-BB---?B-Bo?B----?-M--------M--B?--M--?-??--EB-?M?BBB-oMB?B-M-EM-B--M-EoEo--B?--M---M?--?EB?oM----M-M--MoMMBB-BM-?M--EEBB--BB------B-M--B--M-B--ME----o---oo
--M-EB-?-M--M-EBEBM-MoM?B---MM-B-o---BM---?--?---E-M-?-B?---?--?E-Eo--oEM--BBBo-?B--B-?o?--EoMB?-?-o--M--MB-o-oM-E?B-----o-MBEM?-Mo--Mo-?BM----M-Mo?-oo?-B--B-Boo??-o?EoM-M-M-??o-MM-E-M----B--BM?MBE-oo
-o?--B-??--o-oB-----B?M-o?-----M-?M---E??M-BE-o-o?---M-MB??M--o--oM--B-?---EB-??M--??o--o-oB---?M?--MoB--?MMME----o--B--o??---M?---MB-?-B-EMM-?-ME?Mo?-E--M-?--o--?oo-?oo-?---B----MMMoo-EM?oo--B-M-M-oo
Mo?M-Mo-M---?--M-B--?-?B?--MMoo---oEMBBBEM-B???ooMoo-M-E---EMME-----E---M---BoM------B-?--E-BB?-B?B---?E??B?-BM-M-B-EM-o-B-----o--?---?-B?--M--o-B?--M-BEMo--o-B----?---ME-oM----?--o-?-??-o--B-?B-B--oo
M--B??-B-E-BoM--MB----oo-----M-B---?-M-o-?BB---MM--ME--------oMM----?B-M-o-??-o--?-MB?----?--o----BB?-MM-?-oB--M?E?o----?-------o-?--E---o-oo--o-?B?oBM-?-M?E?M?o?Moo-B-M-B----o-o-M--o-M?-B-o----BoE-oo
B?oM--oo--EB-?EE-E---o--BMMBEM--EB??o?---ooo---B--o--MB?-o-B-o--M--o-?-BEE--BE?-o?M?-M-M-?MB-o-o---BB--?Mo-Mo---?M?Eo--M-?---Bo--M--BM?-E-M-o-BMEE-BM?-?-E--?oM-E----o?E-----o---?MB-oM-?--?-ooEM-?BBvoo
BBE--------oM-B-MMMo?o-Eo-B-??--BBo--?----?-B?----BM--Mo--BM?-MEM--oo-oo----??EM--o--?-o??o---?-?-?-o-------M---B---BB---o-?---o--B-M----o--M--?--?-?o-B---oM--o-?B--Bo----B--M?EB?M?B?---o------?---foo
-B-EE-E?----o-BE-o--o----E-?--B-MM-M---oE---?--MMo-----ME---?o-B-B-o-M-------M---?----BMM---B?--o?-?M--oE?-o-Bo?--MB--oE-M--?-o--?B--Eo-oo-?E?--M-M-E?oM-o-B--B--o-o--Mo-MMEEB-oBo?ME--M--E--B?----oEfoo
--MB??-o-----B--M-oo-oBE??Eo--?--o?-?BB-M-?--MMoEM---E-o?MEE--EM-EBE--oB--?E?--o--M--o?-o?----oo--oB-o---E-M?BB-?-B-----o---?--?-?---M--B---MB---M-B???o--o-BBBM-?M-E--M-?-MM-o-B---MMooo--?M-?M-M-M?foo
M-B??-E--??B-Bo---?-o?---B?--E?--B??E-Mo---M?o-o--M--B--BM??B--?-?E?--E-M-?B-?-B-MMoo----BM-----M--?---M--?-B-E-o-?oB-E------o-B---M-o-oM--Boo---E--E-o--M-o-?E?-MMMBB----E-M-o-EooEBM?--Bo-B--E-?M-ofoo
?--TB--M----M-E?-o---?-B--------MoMMB-?E--?-M?oB-?--??-B---?-M-EM-B?M-----MT----MMEBE-----?-?Bo-EM---M-----EM---??-?MB?M-?B--o--BoB-B----------MT?Eo-B-B-E----MT?---M-BEM-----o--BM---B-?E--EB???----foo
M-E|?-o--M??o--ME--o-M-T-M-oB---BBoBB----o-?oM-T--B-EM-B--TBMT-BE--MB---BMo|?--T--TBB--BBoTooBM--M--ME--o-MT-B-o-T-MMMT--E--oE---o---?--?o-BEo--|EMTT?---BTBTTE|?---B--M?ETT?-BE?-BBoM--MMT--M--?T-?Bfoo
m-M|---MB?E-?oE??BM?B--|-B---?EEoM--MM??E-??--B|Mo-M-B?Mo-|-M|-oME-??-M-E-o|-oo|?E|--MoMEB|-B-?BM?EM?-Eo-M-|EB-EM|?B--|?E-??M-B?o-?E--MMMMEMM?ME|?E||oM?oo|-||M|-?oMo-M---||-oBB-??-M--BME|-M?E?E|-M-foo
XXXXXXXXXXXXXXXXXXXXXXXXXXXXXXXXXXXXXXXXXXXXXXXXXXXXXXXXXXXXXXXXXXXXXXXXXXXXXXXXXXXXXXXXXXXXXXXXXXXXXXXXXXXXXXXXXXXXXXXXXXXXXXXXXXXXXXXXXXXXXXXXXXXXXXXXXXXXXXXXXXXXXXXXXXXXXXXXXXXXXXXXXXXXXXXXXXXXXfXX
