--M---oM-o---M-o-Mo--?E-B--E?-M-o-?--o-?oE-BM-Mo-EEM-?--?--------EoM-M-?--?----?-?-E-Bo--M?Bo-BB--?EEM-MB--M--?------MMEEM?Bo--o-MM?EM-B---Mo-ME-MMo-ME--E-BMEBBM-o-o---o??o-M?Moo?--BMo--o??-o--?-----M
B-----?--?o--ME-B-?o-E?-Bo-M---oo-M-B?o--M-M-oBEo?B-Boo-----BB--B--??B----?B-----ME-E?M-o---?E--M---M?--M-?-M-B-M?E--EEB-?oM--o---?oM?-EMB-M-----B-M-M-MB?-?MM-oo?--MMo-E??-E--M?oBo-?--BB-E-o-MEE--M-B?
B-------EooMo-M-M?M--?-B----B--B?o?B---M?-?o---B---o-BM-E-M---M--M---o-o----o---?oB--EB-M-?BB?----?--B-MBMBM----M-Bo----oo--E--oBoMB-EEBBMB--o?E-B-----BEBM-----oE-M-------B?M--o--MB-EEE-B--MEBB-oEM---
--?oE-E?----Bo-oM-MM--B----E----MM??EoB----?-B------?oo-?B?EEMBo--MB---?--M--?---B---MBo-E--??M---B----?E-o-E-----MB-BB-??-----E-BB?-?B--M-------BBoEM?MB--o-----M???-?-----?--M------B?---MM-----B-EM-o
-?M----M-----M-M--Mo-MB----M---o----?--o-?-E-?M-?-o--??MBBMMM-oME----B--Bo-EMo-B?o---Mo-----o?--MB--M?B-BM--ME??B-B-?o-----MoEMBoMM--B-B----o--oo-E-MMB?E---oMM-----o?M--BMBEo??M-----?MBBo-M---?oM-??M-
o--?ME--?-ME--?-???B-B-o---?oE?--o-----o---BE??-M----M--M-B---B----E-oEoMo---o-MMo---B-?-----?oM-oMEBM?--M?-M----MMo-o-M--Bo-?oB???E?-o-BM-oM-B?---B?---B-o----E?-E-B-B--?-?BB---MB--o-o-o-o?-M---E?oM--
BE-------B------o-E?-o-?oE--BM--M--EE-?----?-?---M-o-B--o--??---Mo-B-MMo--?o-?Bo--?-?--BM--?---?------MEo-?-o-?E--?-?--o-oo?-M-BB-B?M-Eo-M--?---M---oM---MM----B-?M-o?----M---Eo--B--B--o-?oE-B---MMo---
BBB--?BB?------M-o?MB-?-BM-o-BM--o-MB-?---EoB-?M----o-MB--EoMM----EB----?--M-Moo-o--??B--??--o---oo----M---?-o----B---o--?------o-------B----M-E--Mo??-----E-M-M-o-o---E?--MMBBB--B?E?M-M?-M-oo--o?--MMv
o-o---E----o-E-?-?ooMB---M-?-MB?--E?--B---M--oB-MoB-----o---oEM--EMoB----?B?M?----M--o---o--E?M---M-----E?-?-?-EM--?M-----?--E-----M-?--EEoMM-oMo--------B-M?-BBB-?oB-MM---?---oBMB-Bo--EB-?M-MB---BB--o
----------B---?--?oo?MBBEM--B-M?M-M-oo?--B-oM-o?o?o---oBB-MB-M---M-E-o---E--?E--ME-ME-Mo-BMBMM---BM---Mo-EEEoo-?o--o-B-?B?M-?----oM---M---?--M--B??-----E?o---o--o---BBo?--BB--M?-B-ooM-?--B??o---?-o---
MBMo--Mo-E--Bo-M?B-o-B--??oo-?-Bo?---E--EM----o---MM--o-oBB-o?-B-??--oMB-------M-?MBMo-M-o----o-o?M-B-BE?MMBM------o-E---BB-BM--BB-EM--o?----?o?MB--M--??---?-o-??--oEE-?---B-M-B-?---?M-oBo-?-----oM-M-
o--B---oB-M-Mo-B?--oo---o-B--Mo-?-oM???oMo-?B-o??MM--MBM?--?-B--------M-?MM----BEMBM--?ME-?-MM-MME--o--M-M-E---oEM?o-B-Eo--o-?o--M-?-B--M-?---o--oB-?BE--B--Mo-o?ME--M-Mo--o-B--ooB-M--B--?EM--?M--E-EEB
-MMMM-MEooMMBEEo?--o?-M--o--oE?-BMBE---Bo--oo-?----?-M-MB--MBBB--MMEoB?-o---BB--?Bo--E---EM--o-?B---oE--BEM---??ME-E--o--EoEBB?T--B--o----BMEMo---M-oBB-T--o-ooE-MM--Bo---?o--?M??--o------Bo-M-?-?--M?B
M?MB-ToMBM-?T--TT--TB--BB??-oMBEo-B??B---MBBETMoTMoo?--TMBo-M-Boo--BBM-TMo-T-o-T?o-----E?---------B-BB-BMTT--??B-----B--T?M-??o|o-o-oE-?T-M-?B--EB--BoT-|--E??M--TM???-o?o?MoB----EoMM-o---BM-Mo??-EMMoT
mo-oM|-BE?--|M-||BE|-M??E??B-E-?---MMoEBE-M-?|o-|E-o-BE|?B--o------BBEo|-?-|---|--oBEB--?E-?BM-?M?EE?oE-?||oB-?-BBMM?-B?|B-o-E-|-?Eo??--|E----?M?BEoo?|-|o---BM?-|MoB-B-?-o-B-M??E--o?o-M-??EEM---MME?-|
XXXXXXXXXXXXXXXXXXXXXXXXXXXXXXXXXXXXXXXXXXXXXXXXXXXXXXXXXXXXXXXXXXXXXXXXXXXXXXXXXXXXXXXXXXXXXXXXXXXXXXXXXXXXXXXXXXXXXXXXXXXXXXXXXXXXXXXXXXXXXXXXXXXXXXXXXXXXXXXXXXXXXXXXXXXXXXXXXXXXXXXXXXXXXXXXXXXXXXXX
