----------------------o---------------------------------------------------------------------------------------------------------------------------------------------------------------------------------
--------------------------------------------------------------------------------------------------------------------------------------------------------------------------------------------------------
--------------------------------------------------------------------------------------------------------------------------------------------------------------------------------------------------------
--------------------------------------------------------------------------------------------------------------------------------------------------------------------------------------------------------
------------XXXXTX--------------------------------------------------------------------------------------------------------------------------------------------------------------------------------------
----------------|X------------B----------------B--------------------------------------------------------------------------------------------------------------------------------------------------------
-XXXXXXXX-------|------T--------------------------------------------------------------------------------------------------------------------------------------------------------------------------------
----------------|-----B|-------------------------------------------------------------------------------------------------------------------------------------------------------------------------------v
--------------T-|------|---------------?---------------------------------------------------------------------------------------------------------------------------------------------------------------f
--------------|-|------|-------------------------------------------------------------------------------------------------------------------------------------------------------------------------------f
--------------|-|------|---X---------------------------------------------------------------------------------------------------------------------------------------------------------------------------f
--------------|-|------|---XX--------------------------------------------------------------------------------------------------------------------------------------------------------------------------f
--------------|-|------|---XXX-------------------------------------------------------------------------------------------------------------------------------------------------------------------------f
--------------|-|------|---XXXX------------------------------------------------------------------------------------------------------------------------------------------------------------------------f
mE------------|-|------|-X-XXXXX---------------------XX------------------------------------------------------------------------------------------------------------------------------------------------X
XXXXXo--------|X|XXXXXX|XXXXXXXXXXXXXXXXXXXXXXXXXXXXXXXXXXXXXXXXXXXXXXXXXXXXXXXXXXXXXXXXXXXXXXXXXXXXXXXXXXXXXXXXXXXXXXXXXXXXXXXXXXXXXXXXXXXXXXXXXXXXXXXXXXXXXXXXXXXXXXXXXXXXXXXXXXXXXXXXXXXXXXXXXXXXXXXX
