E-MMMo--EBo------o-B--EMBo-MB-?oM-o-B---oE-B--B?o--MB?-?BM-B------BE--EMME-M?EE----?--?Bo-M?M-?-ooo-?o-?-?BMB--oB-MooB----??M-??Mo-oo-EBBE--M----B----?-?-M--?o?--?o---E?---?---?-E?-M--E-o-M-?Bo-o?M-oo
-o-?o---B?M-M-o---EM-EMME-o--o-M-EB--BM--?---E--oBMoBo-M---M-?o---E?-EBEoMo?-----o--MB--M-?-MBM-Mo---oM-o--Bo-M--B-------E-E---M-EE-?--M-?M-o-o-B---------E--EM-M-oBM---BE-EB??-M---?-M-B---o-----o---oo
oEooBB----Bo-B-M?-M?--B-B--BB-o-E---?o-M-?-o---?-----B----ooB?--o-?--M-?-?-ooM?--?E--Mo---Mo------Eooo-Eo---MBB-o-?B---oBBEBBM----B-?BBM-B--oooM?B-M-B-?-M---M-MM--M-EB-?-M-E--B--?---?oo-E-----------oo
E-o?--o--EoM??o--M----MB-E--BB--B-?-o?-Mo-B--?-M-oE--E--B--B-o--E---oM-o?BB---o--oB-M-o?BEM-E---oM?BB-B-E-EB-?---MEo--E-M-M-B-M-B---B-??-oo----BMBMMB-M-?o?Bo-B-?ME-E-?-E---M-----EBoB?o?-?--M--?B----oo
?-oMBM?--M-MB--oM?--M-oM?-?--o--o--?BB-M--Mo?-o--?Bo-MoM-BB-?oM-?B-M?---oo?-?EB-----B--?-BB?----M?-o-M-??MM-M-o-oBBMB?--B-Bo-oMB-oM?-E--ooB--M--EB-BE-------M-M-o?B-B----B-B--o-------B---B-M-BMo-----oo
-E--M?-BoE-o--E-?-M-o-M--EM-EEoMMB--oM--M----M--E?--BMBo---M-?--B?o-EE-B-??---M-E?---MEE-B-M---E-??o--BE?---B-M?-?EMBM-?B---B-M--??--B--ooB-M---B----?o-?--BBE----Eo-E--?o-o?M-M----oB-?---??----???--oo
oM-?M-?EMM----B---E-o-?o-Bo-M-BB-M--o-ME--oM--M-B-B------?EM-M-ME-----M------B-------o----M--M?-??-?E--?-o--MB?B?-BooB----BMB-o-oB?-M--o-Eo-M-??o--BBB??-?M---?---B---EE--BMoEB-o-?--M-B-BEoEo-MB-BB?-oo
oM---EBBM-B--o--B-M---?-M-oB---E--o-o-oB?Bo?-EB-B--------o---E----?-?EBEB-B?--o-B--BoM--M-o---?M-B----E-Bo----M-B--?o--?oo----MME-?B---B----MM-M-E-ME-oE-?B-?-M??----------EEBo-?-M-EBo-o-BMBo-EBo?--voo
oE-o-----?-M-??E-?BM-E-Eo-??-----EM---B-B--?--?-?-o---o-B----M-M-B-B-M--?-o?oB-B?----EB-?--E---M?-BE-?-?--?----BB-BB--BMoo--E-Eo--BB-M??o-?--o-B-BE-?--?-B-M?-M--?B--oM?BB?M---E-EB-Bo-o--B-E-----M--foo
---MBB---E-EB-B-MM-o-M----E--o--E--o--BB---M--?---BBo-?--?---o-oB---o?-B---o-oM---B-?---E-o?-oo-MoMMMB------EM----B?-MB?-E--?M-B-----Mo-??-ME-BB-E-E---o-----EBEo----o-?---?B--Bo?--BM--B-E-B--o-MBB-foo
MME-Eo-M-?B---E-E--EEE-M-B------B?-o-B-B-?oo-E----EB--??----B?o-?BB??B----oBB--?-B-?---BB--B-?------oE-?-BEo--o---E?M--?-B-Bo?-o-MEBMooMMMoM?E?oM?-?-oo-M-B--B-MMEMMEM--?Eo---M--BM--M-o-EB-M-oE-M-o-foo
?BBMB-Mo-oM--?--M--M-B--B-?--------BEEB?-B?o--o-B--M--?o?oo--To?-E?-M-BE--B-?-o??---M--o-----MEo?-B-MMM--------o?M-MM-??oB-?EB--?---Mo--E?--M-EB--M-----?--B-oM-?B--?B?-?-------B-?--M-B??-?MEMBM-ooBfoo
---o---MMB------E--?-?---?Mo--BM-Mo----Bo--ME--oo---E?-E-?E-B|Bo-MMo-E?---M?B--E-??-oo-?oB-M--?oB----?oM--?oB??-B----Bo--M?---MB?-B?--?BBB-E??-o---o-EB?o--oMo?--?M-o---M-Bo-----BT---MT?o-o-?-?--o--foo
--Mo--oMB----T?MM?B---?-B--o--?-o?-?-o-----BT-?o-BB----?ooTT?|E------M-ME-??--o?--oE-?-oTB---BTMEM-M-----?o?-?o-E--BoMEB?o-?E---ooB---M--M--?-B?MB--E--B--M?oEB----EBBMMMo?M-?oT-E|o--M|o?MB-o---oM-ofoo
m-M-EB?B-?-B-|Eo-E--?BE-?---E--M-?---M-M?--B|BEM-o--?M?-?-||-|M?BooM-E---E?oE--E-B?B-BEM|oE?M-|B-oo-BBE--MB-E?BBM--E-B--BoMM-EE--?--MM-?B?----Mo-oE-MMo?EoBo-?EB?B-??EEM?M-M?Mo|M-|?B?B|EBooMB-oM-oM?foo
XXXXXXXXXXXXXXXXXXXXXXXXXXXXXXXXXXXXXXXXXXXXXXXXXXXXXXXXXXXXXXXXXXXXXXXXXXXXXXXXXXXXXXXXXXXXXXXXXXXXXXXXXXXXXXXXXXXXXXXXXXXXXXXXXXXXXXXXXXXXXXXXXXXXXXXXXXXXXXXXXXXXXXXXXXXXXXXXXXXXXXXXXXXXXXXXXXXXXfXX
