BBo?B?o------E--M-----E---oMM?---B-oM-MB-?E-E----EEB?B---M-B---B-??-ME-B-o--Eo-o?o--MBBM-MMo-?-o-M--M--E-oB?--?M---B-o----?BB-o--o-------M--o?--oMM---o-----MB---M?M?-EE-o-?MEBMo-oEBEM-E-E-?o---oo---oo
-Bo-?B-BE-oB-MoE?-E-?-?-MM-o-o----?M--E?B--o?o---B?o--oMM--EE--B--oM-BB-EoE-----oM-?--?--B-E?--M-----o-?-B-?-----?-M-MM-E--oB----EM-Eo?-?--?-M--?-E-B?BM---MB?Bo--MMBM-?E-EoM--?-E-B--M---BM-?---oB?B-oo
oo?-oMMM-B-?B-?-o-BM-?-o-MM-M-o-B---M-MMo----B?M-B--?--B----?-?-BE-M?----B-MM--MM?E-o--BMM-M-EM--Bo--?oMEo-M-ME?B-BB---EM?o?E?---MBMM----?-?B---B----E--------------??oE-oM-M-BE??---oEM---MMEoM--o-B-oo
?M--B??-?--?-BMM-o?-?-o?--o---M-E--o-Mo?BE-?---???o?--E---E-MB-BMB-M?-oo---B-MB----B-E?B---Bo----B-??BB---oE--?-o-?EEMB-?---B??-MM--o-EB--BB?---MB---MEB-?BME---B----E-B-o-?-o?B-M---MB--o-???---Eo-B-oo
--?BMM---B-?--B---MEo-EM------o----??E-M---B-EM-----o-M?--?----M-----EE-M?--oEM-?oM--MM--??o?E-M-?M?--ooE-B------oM---M-o---B--??o-B-M---B?-o-?E-?-M-o-?----M?-?EEB--M?-B-B-oo-M-M-??---oM?oo----B--?-oo
--B-Bo----o-----B---???EBBBM-Bo?oEoo---------M-MM---M-M-MM---?-B----BMMBMBo-MMo-MBM--?---MEEBB-MoMo---E--o--o----BB?M-?o--B---o--?BoE-EMMo----?M?M-Bo--o-oMEEo-?-?B---?-?o?---EEEM-BBo----BE--MB---?--oo
oEBB?E------o-MBoB--B??--BM-B----?-?B?o?--BE--B-o--oB----o?o--??----?--?M-B-?------M-B?EM--B-E-B?-----Mo--oB-o-M----E--?M---MoBooEBB-M----B--M-ooEE-M-EB??-B---Bo-?oE---Bo---BM-BM?E-EBoM?-?-o-?-B-BB-oo
--oooM--M-oMB-----B-o---M-o----BEBoM-M-Boo-Mo-----?---o--------MBE-B--B??M?oMo-o-?o---B-MBMB-B-o-o-----EB--?BEo?--E-MBMB--M?-M?B----M-----M--MBME-M-M--?-B-o--o-?o---------Bo---?-B-B----oMMEE-o-E--Bvoo
-MMB?-ME--E?MM--B--o---?---?M-o-M-MEoB-E?-oM--o-B-o?Mo-B-o?-------Bo--MB--B--B-B----E-BB--?-B-M-MBEM-E--E-B?---o-M-E-oE-M-oM?ME-oBBBB-?-oo-EBMEo?oB---o---BBo-BBM?-?--o-B--M-----oME-?-ME--??MB-M-B-ofoo
---M------?E-Bo--BM-B-E--B-B-o---BE---B-----?M-EE-o--E--MB--B-Eo-------o-M--o--Mo--------??-----o-?----oM-?-o-oE-?--o-B??---?------o?--MBoo?-BMM-?B?B-B?-?----EM-E-o?--BE----o-BE-EM?--EB-?B-M---MB?-foo
E--Boo-M----Booo-Moo--BEM?E--M--B?ME--??--E----?-?----?EM--EB-MM---MMBBMB-?Bo---E---BB-?B-B---o----?B-oB?--?o-B-B---M--EM-oEM?-B?-oME?---?----B------MM---EMBo?---BM--------M--o?E?E??oM-BB-MB?-oM?-?foo
Mo---E-BB?-B?E---E--?oM--?-EBE--oEE-MM--BoM-oEo-M--B---ME?BM?BMo---M?-EM-B----o---o-MB-M-?----B?E-M?B?o???-M--o--o-BM-o-E-o---??MMB-M-?--MM--?--B-BM-?--B--??M?-M--oo?---oBE-o----?---E?--B--?o-B-?oBfoo
--o-oMo--MT--B-B-B-B-B---M-------?MB-Mo----B-BoB--E-B???MBE-Mo-B-EM-o?ME-o--o-?-EEMo--EM----BB?BM?-BM--E--oo-o-??ME?o-E-MBMo?E-----oBE--B?B-B-o-Bo--Mo-?M-oB?-E---?M-oBB---ME-Eo--o---M---?-o---oB-MMfoo
-----TM---|-?-M-oB-----o-o-T-o-oBE----T-??-TM-o-o??-MBTBoBB---o-E?BBBB-T-B-oM--BBT?-BoBM-oM-?----M-M---Bo-EM-MM---MTM-M-M-M-o--BT-E-E-ooEET---EMMM-MMM-T--B?TB-T-MTMo--B------B-B?-?-T-o--E--oEoBB--ofoo
m?E-E|-oEo|oBo-oo?--E-MM-E-|---B-B-oo?|--?-|-?-BM-EB?o|M-E---E---EBEM-?|-?-o--M-B|-BoE---oo--BM-B?oEo?BBo--oB?M-o-o|--B-?E-ooEE-|-?---Eo?M|o-o-ooME?--E|o--o|--|B-|B-?--o-ME?oEBB?Eo-|---BM--M-MMB-?Bfoo
XXXXXXXXXXXXXXXXXXXXXXXXXXXXXXXXXXXXXXXXXXXXXXXXXXXXXXXXXXXXXXXXXXXXXXXXXXXXXXXXXXXXXXXXXXXXXXXXXXXXXXXXXXXXXXXXXXXXXXXXXXXXXXXXXXXXXXXXXXXXXXXXXXXXXXXXXXXXXXXXXXXXXXXXXXXXXXXXXXXXXXXXXXXXXXXXXXXXXfXX
