---?ooB-M?-o-oBMBoE-E-?---oM??-o-M?---EE------?BMB--------M-?oBo---o----BB---o-BBM-B--o---?--B-o--M-o-BB------?--EBE---Bo---MEM--MMB---M?E-M---E---oo-?oM?M-----BM?M---?-?---B?-MB---o--EEMo-MB?MM??B-oo
----B?o--o-?o--oBEBMMEoo-EMMME-?E?--BM---oE-?B-o-oBMBB-M?---E--?MB?o-M?----MM-B-oBBEB?-----M--o-B---ME-EB?-MM-E-MME?-oB-Eo-oM?-o-??-o--B-B-M---B----MBo-B?BEME?-?o-o-Bo---B-M---?-?ooM-oB---MoB---EB--oo
-oB--M--EM---oM-M?-B-B---BBM-??MM?-o-oMB?BM-?--BE-?o--EBo---M-oBM-Moo-M-?---?-o-?MB-oE-BoM-----E----M?MB-oM?-M-----o--MEMEM--B--------EBMB--B--ooE-EoE--??--M?M--o?oo-ME-B-o------MB--?-MBMM?BMoB-?---oo
o----Mo-M--o-oE--MMoB--Mo-MB--??-?Bo-MM---M-?---M-----MM?MBB?-o--B--E-----------M---oBMoooo-ooo---??---o-?M?Eo-----o-o?-EB--ME-BBEo-------EB---MM?E--Moo-?o-BE------o--B-M-?B-Mo-o?M-M-oB-B--B-o?M?M--oo
?E--E?--oM-o-o--oBM---B-MM--B-E?-?B-M-M--E--o----B--M-o--o?B-o-o---EBooo----EE-?o?M-Mo?-??-B?-?E-o-M?-MBE-?B-E-B---BB-MBB?M?BMM-???MM-M---M----o--MoMM-?-----BBo---EM-M--?o-----E--BMM-o--o---E-Eo-?o-oo
?MM-ME--oMBME---B-----o---?-?M?-oM---o?B-?---oE---EE-B---M--M?EBo-----?--?M-??-Mo-??----M---oMBMM-B---?E-?--M--BEo-o---B-M---M--M?B-M---o-oo?M?--oB--o?o---oE-BE--E-?--M-?oB-??BM-Eo-?M?---BM----?-BM-oo
MB-o--E----M---o---o------?B-oB-?BB--??---M-o-M--M-----------?-MB--MM-ME--ME?-----o-MME--?-oM----MMB-B-M-?-B-B?-?-E--EoBoM-o-oB-EoM-----oo-BB-B--BM?-o-BE-?-?--?B-----M-?-?-M?B---?---------M----B----oo
B?---?M?-oBo---M--?o?---?M-B?-o-B-o---Eo---------?--?-M-Mo--o-M-o-o-Mo-?-BoMBM?-M---EBBB---?--E--?o?-?BM-E---Mo--B?--M-M-M---?-B-E--oB--?-?oM----B-oB---B-B-MB-Bo----MM---BBMoMB----MBo-MB---M-M?-M-Mvoo
?MM-o??M-MM----?-?M--?---M-?-?MM---M---M-BB-EEM-E-oo----?-?-?-----E??------E--BB--EBMM--o?----M----BM??-B?--o-M-?M?-----MMo-o?--MMBB-?--Mo-BM-?-??B-----oMB-MME-o-?M-o--o-----oo--?--?o--Eo-M--?MoE--foo
?-E-?-M--ME-B--oB?-o-EB--o----B--MB------MMo-----ooEoMoo---o-B?B-??-EBB----M--B?--M---?EMM---?-M-M?-MM?-EE---o---BB-E-o---E-?-o-MB-MEE--o?--o-B-?BEoB-?M--?Bo--BBM-o--?Bo---E?--oE-?EM---??B?-EoB-?--foo
o-BBM-E--o-Mo?B?M----BoE?BEo-?--?o--?----BM---M---MMB---Eo?BMM--MB-B--BM?MB?-MM-EME--o---?E--B-Eo---M----B-o---M-M-M-Bo-oM--B--M--?--M---M?-o-------oB-----MBBoE-B--E-B-?--M?EE--M-M-B-?M--o--??--o--foo
--MBE--E?M?o----o-B-MB-?-B---?--------BoMM--?---E?-M-M--?-----?----B-?---?--B---M??M--E?--?----------B-E--oEE-?M?o----M-B-MM-------oBB?-oMM-ooB--o-?o---M?M-M?-?oooo--Mo-o?BoBMM-oEB---B--E-BEB---o-Efoo
---oME----Bo---E--M-E--o-M--M--E-ET---oM-?BB--o---Bo---o--M-?EEB?MM-EB-o??E-EBo-Eo-o--MoB---B-----?--o-M??EBT---BB?--M?-??EM-Eo-M-MEoE-M-E--B-E----BMoEB-BE---EM--MTM----M?-BM---M-BB-E-B?---?Mo--?MMfoo
B-T-M?-T-TMo--T-T-M-TB-B-M------T-|---?-M-E--oM---B--Bo?---?-??E-oo---MB-oT-T--?M-E-M--EM-TBM-ToT-T?--oTM-T-|-BB----M?oEB?BT-M-ooTo-TB---ToBo-BBT-T-B----EM-B?To-TE|oB--MT--MB--?M-oETB-E-T-?MBBM-TM-foo
mB|BM-?|o|--oM|B|-MM|M-ooME-?B-B|-|?M--E--M?EMB-M?-oE-MB-MMM--?-?M?Eo-o?B-|?|-oo-E?EE----?|B--|B|-|EE-M|--|B|EB??B-?--B-Mo?|MBM-E|?E|---B|EEMoEB|o|M---EE?--B-|E-|?|----E|-M--EE-Mo??|M-M-|-o-o?-E|?-foo
XXXXXXXXXXXXXXXXXXXXXXXXXXXXXXXXXXXXXXXXXXXXXXXXXXXXXXXXXXXXXXXXXXXXXXXXXXXXXXXXXXXXXXXXXXXXXXXXXXXXXXXXXXXXXXXXXXXXXXXXXXXXXXXXXXXXXXXXXXXXXXXXXXXXXXXXXXXXXXXXXXXXXXXXXXXXXXXXXXXXXXXXXXXXXXXXXXXXXfXX
