-?-M?---M?-ooBMMMM-B---o-?-BEoB--B-M------E-o?--B-?B?--Mo-Bo-----B------Bo--B---B-Bo-Moo----MB-EMM-?--------M?B?--MM-BM---B-o--B------E---?--B-ooEM-B-M?M-MM-E-ME---o-B-o?-oBoMMoE--B---?-BBMM--B-BM--oo
----EB----M---o---o-?ooE-o?E?oB--M--B--?-B-o--B---B-o-B---oM--E--MMo-o?---MB--Eo-oBB?-M-oMM?-----MME----oooM-??BEoo--?--?--M--M--M----Mo-MEoB-oEoB?-oMM---?M-M--------E-EMo-MMB----B??-o??-?-BE---o---oo
---??BE?--o-?-?o-?o---??---BB--o--o-MB-------oo?-?B---o-M?E-M-?MM?-E?M--B---BoME--?-------M--?o--BoMMo-?B--BEBBo---oEooo--B-EMBM---o-ME-?-BEooEBE?B---M-E-E-o-oBB?-BBM?BBBo-?oBo-oB-B--ME--B-MMo--M?--oo
?---?E?MoB---B?---EM??--oM-o?B--B-M--BMMEM--B?EM-M?-o??EoB?oM-o-B?EMB-M-M--E---?oMM--o-M-MBM--E---B---E--MMM-B---B?--B-ooM----B-M?o?M---M--?B-M-?-EBoo--B-?-?-B-M-M--???--------oM---?----o-oo---?----oo
-?ME--?-o----E?oMM--EBBMMo---B-MoMM-MoM?-Mo---?-??---MB--MM-BM--B-B--M--B-----?-oo-Mo-M-M---Eo-M---E--?----oBo----M-Mo?oo-??-?-M--?-EMM??---E-M?--MM-?-o?----o-E-M?--BB-oB?Bo-----o-Mo--E-B-BBM--Eo-M-oo
E--?----Bo-BBM-oB?------oo?-M?MMME----o-?o?B--M-oM?---o?MM-MM-B-BB---Bo---B-----E-BB-MBBM??---BoM-B?E--?ME?Eoo-BB----?BMoM--M-M------B----?--o-?M--BoBo-?--ooEB-?M?B---?---B?----o---?B?M--oMBo-M-----oo
M-?E-B?oMM-BBBoBo-?-M?--B-E----oM--M-o-oB?E?ooBM---B-Bo?B-EBo?--??-BM-?BE??E-?--B?E?E-M-B---?--M----B?M-?M-B-BMM?-B-MM---MMM--MM-ooBBo?-E-o?-o----M-BEB--E-??-oo--B--o??--M---Mo--E-Mo---MB-oE-?o-----oo
MMM-B?-o-?-MBM-?-M?o?Bo-ME??-o-?BMoo----?-----?E-o?--EE--o--?-ooBM-?--?M----BMBM-----?--E-?-M-MMM-?---B-Bo-E---M?o?Eo-?----o-EoB?M--MM----?--B?o-M?oM---M?Eo?--EB-?-MBM-E---o---M--?E?-B--M-BMo-o--MBvoo
EM--E-oMoB-E-EM-o----oBMEM--M-o-?-o--o-o----o?-M--?-?---o---M--B--oo--E?ME?-o??-MB-o??-M---oMMBMM-M-BMBM-o-?-o-BoM--E?-M-o?--M-----MBB-----ME---Mo-o-o-B-M---M-ME-?--M?BM-M-ME----M--B--o--MB--o---E-foo
----B--?B?BMB-E-BE--?--o-M-BEEo-oB-oo-oM--?B--M?-?E-?M?--?-?--B?--M?E----M--B-?----o-o--?M-?-??M-oME-M--?oEEMM---M-?B?-?-o-??M--ooEoB-EM?B-EBo--M??-MoM-B--B--MB?----BMMEB-??BMoo-M---M-------o-?--B-foo
-o-B?E-MM--??-Bo-?ooE-oo-MB?M-?-?E?B-BMBEEoMB-M---?B-----B-MM--BB-E-?M---B-oM---o-M???--B-B--E--?M-?E-o?BMB-E-B--EEo---o-EoMMB-Mo-?-EB???------B-?EoM-B--BE?M?-?E?o?oBoBM---E---M-EE-Eo--?-oM-MBE-?M-foo
--?-?B?oo--Mo---?oo-M------?B-Eo?-?o-EBB--Mo-o---?oo-o---M?-?Eo--?--BB--o-?E--B-M--B-E---BB-B--BE---?M-?EMB-MM--B-?------B??M----EBEM?E-?M-Bo-BE-?-B-M-o--MEB-B---?--Eo----M?---o---o-M--oE--oE-?E-E-foo
ME-EM--BB-o-B---o-?BMB?Eo-EBo?-M---EoBE-???-o?B?Bo-Bo?--o-MB-???----?-M?E--B--o-E---T??M-B-B?B--?---T-o--?-M--BoE?o--ME-o?-oM-EEB------M-o----?-E--E---?----?--B--?--MB---BEM--BB----oEB-o--Mo-MBB-?-foo
-T--?--B-??oET--oETE---T-?B----?EoBTB-M-MMBE?-E-o-o-M?-E?E-T--E-o--T?o?B-oM--BMEM-?-|M-M-TE-?TMo-o--|TEMT?M-ME?--?MTB-MT-?BB-E??-To?o?T--o-BEM-MB--MoM-B-----TT-o--E----M--MMoT?To---E?--To---E-?-B?-foo
m|E?M--M-E-o-|M-E-|MMEB|?-B-B-E-?--|MEM?---?EoB--EMB--M-oBM|oB--oo?|MEE?BE--BE-M?-oM|Eo-E|B?-|-B-ooM||-M|?-?E-E--E-|MEM|-BoE?MM-?|-EE-|M--E??oEMo--EMM---?EM-||BM?--BB-EME-?-E|B|-?BB-BBB|EE------?B-foo
XXXXXXXXXXXXXXXXXXXXXXXXXXXXXXXXXXXXXXXXXXXXXXXXXXXXXXXXXXXXXXXXXXXXXXXXXXXXXXXXXXXXXXXXXXXXXXXXXXXXXXXXXXXXXXXXXXXXXXXXXXXXXXXXXXXXXXXXXXXXXXXXXXXXXXXXXXXXXXXXXXXXXXXXXXXXXXXXXXXXXXXXXXXXXXXXXXXXXfXX
