M-oM--M-M--M-EM--B-?-?---oM?BB-MM-o-o?M--ooMEBM-E-o-M-B---?MMB--oB--?MM?---??B-M-M----o-o-E-M----M--BMoM-B?BE--BM-B-E--MM-Bo--B--o-oM--??--o-o---M-E-M-E---M-MMB---?M?M----?EEoo---BE-o?oo-M--M---EMB-oo
-o-E?-B?-?-?-?oo-o---o?BoB----oMM--?M-o-M??B--M--EoE-EM?---?----?--oM----Boo-?oEEo-o-MM--??---oE-?MB-E-M-B--??--o-----o?B-?ooo-BB--B?M----EE------?-?EB-M--??---oo--M-BBo-o-B-B-o---BMM---B-Eo-M--BoM-oo
--o-????o-?o-BMMM--Bo-BB-o----E-M-?B-oM?-?--BMB-?MBB-?--o---?oBoBo-?o--M-EoBM?B-MB?--o?-M-o---BM--Bo-?M--M--?--oo?--o--B-M--M-B-M?---------?M-B---B---???Eo--B?MM?o?-??E-E-B--E?-?o---M--MB-M--BEE----oo
--E---ooMo---B?--B--M----?-B-E----BB-?-E--MB-?----?M-?--oEMoM-----?MM?M-MMoB----M---MEM?o-B--E------o-M----o--B--oBBM?MB?Bo----B?---B----B-?-B-M-?B-?-?oM--BMo----M-??E-?--Bo-?o-?--B------?---B???-M-oo
-?-o---?-BoEMoB?-M-M--B?MM------oBM--BoB---M-B-M--o-BEo---M-Mo-??-o?M-??--E?oo?oM---o-----BEo--?E---o--MBo--B-B-BM-o--E-?o-M--E-E-B-M---ooo?M--o-M---o-oB-BE-------oEEM-?-B-Bo-BM?--E---?--?-oBM--o?M-oo
-------oo-?--B?oE--EM-oBMBE-BM-----oo-?-o-o?---B-o-E?M?o-BB---E?BME--M---EMMM?--oE-?M-o--BE----MM-?????--Eo---M--BBo-o--?-Eo-??-Bo-oE---M-?E--E---B--MBo??E-E----o-M?M-EBMo--------EB--Mo?-MMEBo-E-MB-oo
oBoMo---?-?---B?-???--?BE-M-o-ooBMo??-o?----Mo--E-B?--BM?M---M-?-oM--Bo--?-?---E-M-Bo-?---B?-M?-?-Bo-ooE-?-??M--B-E-?-MB--?--Mo-----MoBB?---oM--?----o-MM-?M??M-M-o-M------B------E-o?-Mo-BMMM----MB--oo
-----M-Bo-oBE---B?M--M-BB-B-----o---E-EBoB-oM--EM--MMBMM-M---M--o--o-B-B---?M?-?-??------B--B--o--E-E?-B-o--?------B-??BoB-?B--BM--?---M----M?EoB---MBB-?-o-EB-o-B-?o-----M-M?--??BB--E--------E--?--voo
Moo-?B--M?---?--M?-oBoB--E?-B-ME---MM-?E?-?M?E??-B----E-EoM-E-M-o?-------oE------o-M--M-o-E?B--o-M?M?M-Bo?-o-?-----?o-B-?Bo-MBo--?---B-M?----?-M??---Eo-MB---?o-?M-EBMo-??--?----?B-MoM---E--BoBoM-B-foo
MB?--B-BoMo---o--BEE--------B-B-oB--?--BBM-B?M---?oEE-MBB-Eo--B-MBM-MM?-B----?-E-Bo--E?-BBB-E--E-?-BBM-o-MMMMoMM-MM----BB-BM-?----BB--B-B-o---Mo-?oM-Mo-o?BBoB-o--BM--MBMB--B-?-oo?-oo----B-oM?E?-o--foo
-M-M--Bo-E--oB----BBooBo?--BEo---?B-MEE-?-oBE-----M----?B-?-o-B-MMM-?BEo-B---M-??o-BB-E--o--?-oM-M?-----EE-MB??-o?-o--EM-----o-Eo-?-oE-?M--?-----B--M?-MM-EBEoB-?----BMoo-EoM--o-----?-E-?o?-EE-o---Bfoo
-MMM-o---MEEo--M?---MMB--E??--?BEEM--BMBMMEB--B?---B--E-Mo--?E--MB?EM-M--B-o---Eo?B------E--E-B-EB--B---M?-?-MM---B-oo---E-?---MM-o?M-Mo--E-E-?M-o?o-M--E-B-B---M--o?--??--E-MMBo-B-oM-?-E-?E-?BB---?foo
-?B-B----o?--oooB--o?--E-M-M---?-?-??---o--?-?-B--?--?M??oB-BB--?-BM------B?T-T-oBB-?M--o-?-B-E-MT-oM--EM-----oM-EM--MM-oBoo---B-o--o---o-BBBM-B-Bo-MBoM?ME-o-?---BM-M?B--???Eo--?M-o----MoE-o--?--o?foo
o---ME-M-BEBToT-MM---o-M--B-o-oTBo-o----Bo--MB--o-Moo-?TTMooo--M---B--B---EB|-|-?M?--TT----M--M--|MEo---MM-E--T-MTET-B--TBB?-Eo---METEBM-?o----oBM-----TB-T--B-oo---Mo-BT-oM?-B?-oo-?M?-TMMBM--Boo--?foo
m-?E--?-?-M?|M|E?M-Eo-E-oE-BoM-|-M--o--EMMM-BoEEMMB--o?||Eo-o-Eo-BBBB---B??-|M|?---Mo||MEB---B--?|MMM-ooB?-?o-|?-|-|EEB-|oooB-EEEo?B|-?B-E--o-oBooEM?oo|-?|-M-BMoME-M--?|-B--Eo??-MoBBE-|o--MMEoE-oB-foo
XXXXXXXXXXXXXXXXXXXXXXXXXXXXXXXXXXXXXXXXXXXXXXXXXXXXXXXXXXXXXXXXXXXXXXXXXXXXXXXXXXXXXXXXXXXXXXXXXXXXXXXXXXXXXXXXXXXXXXXXXXXXXXXXXXXXXXXXXXXXXXXXXXXXXXXXXXXXXXXXXXXXXXXXXXXXXXXXXXXXXXXXXXXXXXXXXXXXXfXX
