E-EM?o-MB-Mo-o-o-?-o---BooM-E-B--oEoBoo-o-oE-B--?Eo--M--BBB--?------?M-oEB?-?-?-?-?B-?M------o??M--MEMBo-?M-BB?BM---Bo-B-o-E-MMEM-M-oo---B-o?BM-o---o??--oM-?BoMBoE-E-B--MMEB?-oBB-M--E?B?-?ooBM------oo
M--E---Mo--BE--ME??o--E?-B--ME-B?---oM-M?M-?oo-E--E?--B--Mo-o-------o--MB?o------M--?-------oo-M-o?E??-o?M----M??-B-B-oMMEB?BBo-ooB--?MB---M--MBMM-----?-M-o--o--MM-BM?Eo-B--BB-?E--?o-M-Eo--EM-?-o---oo
B--?B--?----M??oM?---??-??----o-?M?M-Mo-M-Bo?-??-MBBo-E??M-MMEM---MMMBM-MMB-B--?oB?--E--M?M?--?-oM?BB---MBo--M-?M-----??o?-?o?-o---ooMo-???ME--ME-MoEMo-M??o-EEM-----?-?-BBM-B-E-Moo-?----EE----o---E-oo
BM--B-B??-B--oEo-B?o---?ooo-?-M?B-M-?-B--o--E-?---M--oB----o-B-o-Mo-o--Bo?----o---M-?MoMMM?-E-BM?-M-o?o?-o---oM--?Eo?o-----BBo-M----B-o?oB-?--M--M?--??-M?---?MM-E?----BMEoM-oB?MBM--M-?---MBE-BMo-BB-oo
Mo--?BMoo-o-o----MMoE-?-M??-------Mo------?-------?--E-BoM--o-oo-oM-o-o-B??EM--oM--BoE-----E?-B?EB-----B?o-?--MEo?oEoo-Mo-???---M---M-M-?o-B--B-B-B-o--M?-oB-?---?M?M??--?-M?-M?BB----?M?Eo--B-?o-ME?-oo
Bo--??--M-MM--?BE-B--BMB?-M-?-?-Eo?Mo?--o-BBMoMEEoB-o----EM-M--E-?-----M-?M--o??BM-BBM?-Mo--?M-?-oMoB-MB--B---M--Bo--?--MM---EB-B--o---BM--oM-?M--??o---??B---BM--BBE--M-Mo?-ooo---o-M-?o--M--B??o-MB-oo
oo?-?o--M-Eo-M-EM-?ooB--E-B---oo-E--o--?Bo--M-MoMoM?------o-M------oo---???E-MBM-oE-o-------oBM?--?-oB-BE-oMEEBM?-o?-??M-MEoB-o-oMoBo-?o-B-B?---oB--MBo--oBE-ME--oM-M-o-???-M-Boo-o?B--o--?-----B?--M-oo
-B?E-B-Bo--?MB-B--E--o--Mo?E-B--EM-EME----o-M?BoBo-B-?M-------BoBME-o-Eo?-E?E-o-B-?--Bo?--M-oE?BB-?-B--o?--B-MoooE?E--o----?-B--o--??-o?oM?oEoMEM?-E-E-Eo--?--?-E-oB-oMMBo-EM?BooBB-EEM?M----BEMoB-Movoo
-B---MM--?M--o-B--B-?ooEMM--o-Bo-----M---E-?M?-B-oo----M-o-?Mo-B-o-Mo-?--?B-o?-oE-o-oEEoB-?-??ooMoEBBMM-B-B--oM--?-?B--M-?E----BoEo-o?--o?B??-oBo-?M--MBMo-Bo--o--oM-?-MMBM?B-Mo?-o--M--M-?o-?MB--o-Efoo
-MB?--B?B-?---M-B?---ooM-Mo-?MBMMMB--oBo???o---o-o-oo?o-?--E?---E-oo??o---oE-?B-?M-BM?M?-ooE-EoM?MBBEoE?Eo?-Eo---MoM-E--o?B-?-oB---BBB-?--?-B-M-M-----B---o---oEM-?--BMEB--?M-MBB?B?o-oE--?E-Mo-MMBo?foo
---M-M-E-MEMB--B-?-EE----?----BM-ooo----o?E-oo?M-B--Bo-MoM-B------B-ooM----B--B--oM?---oBo-M-MooBB--?M-B-BM-?E-BM?oMM?ooM-o?-?EB-ooME-oM-o--oE--?o-?---EM-oo--EMB---?---BEMBBoEo?-BBBM--M?B?o---B-o??foo
o--?-MB-BoM-------oBM-o-o?o?E-Mo-----oEoEoMEo?--?M---?oM?-MB--E---Eoo------o---?-??oMoo-oM-E?M?E--?----oBBE-----B-?--???E-EM---MMM-?B?-B-?-B------oBoMB?-B-Bo-----Mo----EB-?MMB-B-?MBo-E?-?-E--BBBE?-foo
Bo-o?-oB?MM-E?----E??BMB?---?-??--EM-BB---o-M-o-?-oM?--oooEE-BMo-M-MMo--o-Bo-M--B?BM-M-M--?-?-?-ooBoo--Bo-?M-M?-?--MB-MoM-Bo-E?---?oBMB?----?-BMM-?MM---?-BE---B--EMMBo---EoM--o--?-B-o-o--M?oo-Bo-M-foo
---MTo-B----?--?--M?-MBB--MoBMBBE-?--?---T---o--?-?-?Mo-T-B-oBTT--MBoBTo-M?--oT--oM?o?--M-Mo---MM----o-?-E?o--ooM-o?ooTE-?BoEBTT-ooM?oBoTo?BB-o?---M-?M--o-T----o?M-oT---o?--M?ET--o?----Mo-B---o?-Tofoo
mBB-|-o-E-M-BMMBEoB---o-M-?MB---B-EEBoo?-|B?--?B-EEBoM-B|ooo-M||-?o---|oo?EE-?|---o----oM?B-BM-------BMBEBoo-E-M-oo---|B-??Boo||-?EM?MoB|?o-E?MM-oEM--M?o-B|EM-?-BBEM|oBM--?-EM-|oo-EMo-E?EEEEMoB-?|Bfoo
XXXXXXXXXXXXXXXXXXXXXXXXXXXXX---XXXXXXXXXXXXXXXXXXXXXXXXXXXXXXXXXXXXXXXXXXXXXXXXXXXXXXXXXXXXXX-----XXXXXXXXXXXXXXXXXXXXXXXXXXXXXXXXXXXXXXXXXXXXXXXXXXXXXXXXXXXXXXXXXXXXXXXXXXXXXXXXXXXXXXXXXXXXXXXXXXfXX
