--M--B--M-M-oM?E----oE----EM-M--oB?-??--?--o-Mo--M--BM-BE-oB-o-BMB?oo--EM-M-M-E-EBMM--?M-?--o-B-??-Bo---MB----oEM---B-M?-BM-?--B--BM?----BoMMB-?-?B?--oB--o-EB--oB-E-E--B-o----?M-----MB-B??---??---M-oo
o-EM---o----B----Bo--B-?oB-o?-oo--B?-?-o---BB-?BMM-BMooM--oB-ME---MM?M-?MM-M-EB-B--M?o--ME--?-o?-ooB--B----MooB-EE?--E-M-B?E-oM?--oo?E?MoM?MoM?---?M-?--o?-oB-o--E--M-?-M----ME-----MM?--MM-MB-M---E--oo
--M-oMB-o---B---?-??----?E-?-o-M-o-M?---MB-?M-o-Mo?oM?--E-?-?EB-M-M-o--o-?oBMM-M-M?--M---?o-o--M--oMBMo?B-------MM---?-B-E--Bo?EB--BM?--BMoB----oMB-o--?-E-?o-M--MMBoMB---?BM-B?oBoMM-?-o--o-MB--?-M--oo
--MM-Eo-M--ooo?oB-?-?BoM-?EB-?--E-oBB-ooE-o--o---?BM--EB---?---EBo-o-Mo-M-BBMoM?-E?-??MEo--ooEE--B-E----ooB-B---?M---o---M?-ooM-M-E?-?BEMo-E---o----o?-ME?-E--??-M?BMMo-Mooo--?E--o---E?--BM?o-M?-M---oo
o---o?EB--?o-MooM---?MBM------?B-B-?M-?-?o?BEEo-B-o-M-B?EBM-E---BEBB--o-?-M-BE-BEM-E--B-o-??-?---?o----?M-BoM--?--Mo----MB--oBEM--M--o--oM?B-M?B-E--o--oMB-?------?-?---BBM--?BB-o--BoB--?----M-M-B---oo
?---o-M---M---o-?-----?-E-o----E--Bo------o-M--o?---oB-?--E?--?-?----?EoBM---M?---o-EoM-o-Mo--BoMM-M--M-BMM?--B-M---B--?E--ooBB-oo-o-?-B-o?o----oMM-B--B---?--EM-B------o-B-oB--o-oEMEBB-BEE-?MBMEM-E-oo
M-B------BB--M---B-?--Bo---E-------o-?o-----M?-?-----?ooEo?-oBo-?B-----EM?oB-B??B-oMMo-o--M-oM??--E--B?o--M---E---------??E---o?--BM---BE-?oo---------o-M--BBo--o-E--oMB-M-B-?--B-B----B-oM?--?MM?-?--oo
B--oMo-M?M-o--B--EMo-oB?BE?B?-M-------o-------E---B---o--??-?ME--?-B-M-ME--o---B?-oB-o--?oM---?-EMM?---o---ME---o---oo--??-BBoo-M-?--?-?-M-oEo?-M---o--M---o-?BB-----BE---o--MM-M---?-?--?M-o---B?-B-voo
E--MB?-?-?M------MBoMoE-M-----o?--------?-----M--o?--B?--?Bo-o-B-o?o-BMM-?MBoM?-M-------?--M-o?MM-B-Bo-?BMoB?-?B?BMo---M---MMM-?---M---E----?-M-?---oBBo--Mo-E-E-B-MB-BB?-EoE-MBMo-EMB--E----------Mofoo
?-M---B-oE?--E--M----M-o---o--oBM??-ME-M-?-E--oMBM--M-?B---ME--oE?ME-M----BMMoo--B?----?-Eoooooo-EB--o?---M--EM------MM--M--M-MME-oE?-E?-E--?Boo--MMBME?-M?EBM-?-B---E---B-o---M-oB??-MBB??-?E-o?-B--foo
?-M?E-Mo--EMEBB-B?Bo-E--?B?oE--E???E-?Mo--E-EEo?B-o-M--M-B--M-BMM??--?-?--?-?o---E-?--E--B?--B-?B?-?-o-MBMMM-------B?-------o-MoB-M-E---?--?-B--?BB-BB?M--?-o?MBo-E?-?-MEBM-o--ME-?oB???---E??-oMo?M-foo
-B???o--?-M---M-M--EE??--Mo----BEM-?o?Mo-oB-M--oE--oo-oB-----?o--E?--M-oB-M--?-o-BEE--------o-o?-------B--o-B--oB----?-MoE-M?-MB-?-B--BE---?---?o?-M---?B-Eo-----M-M--o-?---??Eo--BM-------M-M------Mfoo
MMB-MMB-B-BMM--E-E??-ooM?-o---?-B-BMM--BM--oB----?Bo-EBM---B-----?-o--EM--Eo--MM-?M--?o?-oBB--BEE?o--?E---o?M?-MM---ooM?---B----?-o-B--M-B--M------------M??o--Mo----o-BE-BM-B?M--E---o--E?-o-MB----Bfoo
-EB----BMToM-TMB--TE-oMoBE---TMB?o-------oBMBBo--MMBE-MTo-o-----MTBT-TM---MT--To-M?-T?-BE-M----T--ET---E-B-?B-o-BMBEooB-o--M-----TEM-o?-o???-B--?--o-o--MMTMMTT-T--M--TTB---B---MB-EE-BB-B-EEB-?EoMT-foo
mBo-BoM--|--E|-EMM|ME-?-B?o?-|o-M---?Bo??-B--o-MB??oMMo|?M-oBEM?-|B|M|-?-o-|-o|M-??-|-BE?-E-MBE|-o?|Bo-MMEBoB--o-Eo?BEM------?o-M|B-?----B--oEE-M--oE?-BEE|-E||o|?E?EM||-oEMoE--MEo-BMEB?-oB-?o--EB|-foo
X----------------------------------------------------------------------------------------------------------------------------------------------------------------------------------------------------fXX
