?------M-?----oE-M-----M-o---MM-o-MB?-?o-?--B----?--o-?Bo--EEEo-?---B?M-o-B--M----M-M?B-M-B-?-o---o-o-B-MMM-oB?o--M-B?o?oMMo-M----B----?-E--?-E-B??-o---??oo-B--oo-??oMMM-?-B-----MB?---Boo-?Eoo----B-Bo
--BEE-E-B----o-M--?-?-------B--E-?BoB-B-?B-Moo-M---o------MB-B-o--o-ME----Bo-?--B-B?---?-----oEo?-----?--M---Eo-?-o?ooE-EB?M----??--o-B-?-o-----o-o-M-E---M--M-o-----o?--B--?-M-EB--M?---BE-BMEo-M--o?o-
---M--?Mo?EE---oEEE?o-----M?-M-?--?B?BB-B-M-M-M?B-EMEo?--M--?--M--M--M--o?o------------M-----M-??ME---------o---o---o-M-M?-MMM---BB-Mo?----?o--?M--B-M?-?--?-oM--M?B--BoME-o-?-?-B--B-B-?-M?M---oB-BMBoo
B--BBB-----M--------?---M---B-oo-?o------B-o-ooo---??o-B-----M-o-oMEo-------B?M----?EB-------?oB---?B?--o-?o--Bo-------o---oB-o----?Eo--MB-oM--?----BB------E---?B-EB-E-o?-ME-?--?-MB-E--oM---B-??B--M?B
-BBBMo-M-?MMB----Mo?M-----B-o--M--??M-B---B?--B--oE-BB?o-?-?-E-oEM?MMoo-B-?B-?o--?-BM-Bo-?E-BE--MME?EE---M?---E-o--?-?o--B---BMo-----EME?--?B-EM---B?B-o-EoM?-M---o-o?M---E-???o-oo?--?-?--o-oMo----o---
--?--M-o--?--?B-Bo--BoM----B-B---o-oMEMooEB?Mo?-?-?-o-?EM-?E-Mo-B---M---?-MB-o-M-?--?-M-M-BMMBEM---E--?-oM-Mo-Boo?---M--BBMM-o---?BE--o-oo--M-M--o?-M---MM-oMoM-o-----?-E---M--BoMB-E----EoB-BoM---MM-??
ME-M-?o-oM---MM----MBBBE-o---E--E?-o?-Bo-MM--?-------?o-----?-----E-?o?--oM---BB--MM---BoMM-EMMoo-BB?oB-oM-E-B-oB-EEM-M??-MM-?-M-----?---?o---?M-B---E-----B-----?oBB-oB--o--oM-M-?----M----MB-BM--o--M?
MB?-B-M-?--o?--M---?--M-MMM-M?-?BE--o-B-E?M--E-B--E--B?---oB----M-B--oooEM--?B?--o-B-EB-o-MB--BMo---B-B--MoMBM-----MM?---E--B-M--oMB----M-ooB--M-EM?--o-------M--BM--?o-----EMMM?-?o?B-?-?-ME-MB-------v
??M?-B-----BE-EEEBEM--?MEE-M-o?-?---?--M?MM??---Eo---?-?M?B--?-EEo-?o?B-?-EBBE-o-BM?E-oB---o--?-M-M-?M--B---BMo----E---B-?-o-?B--?-?EBB---?Mo-?-M--?o?-oE---E--M--?-M-MB?-E-?---?BB?---?EM?o----B---EE--
o-?MBM-M--E?B--BMo-BEEE--BoM---B?Mo--Eo-M--E---M----?--B-----?--B----E--oo-B--EB?M----MEo---?E--?-----M-?M?--E-?--?M-ooM-??E--?o-oEoM?BM?-?-?---?--Mo-E--oB?ME----o-E----------o--B??MB---o----EEM??----
MB-M?-oMoM--?---Moo---?--M-?--o?o-E-oMB-B?-?-M--?--?o?--Eooo?--?o-?---?M-----oM-Mo-----?-M?o---?-M??---Eo--BM-B--E-??---MM--Mo--BoMB---------BB--oBBB?M--?-EBM?----EB-oMo-o--Eo?-BM?-?ooB--Eoo--M--o?---
--?ME-oo??-MM----M--M-?-M---BE-MEEBoM-?-?-EoE?-ME-MEEoM?M--?Mo--EB?-o--??EMM-MM?--ooBMM-o-----MBEB----?M-MM-o---B---o--EoM?Moo--o-MoM?--BB--MB-B--EoBB--BEE---BM---M?--Boo---BM-oo---o--Mo-?-o?--?--MBo?
-MM?-?-?E---o-?-B?B--?------o---?----BMooEB?M------BM--M-MM-??E-B---EM--T?-?-----ooEM-B-E?B---??----oM-?-o-BE-o-TE-?-E??-MB-B?MMMo-M------oMo-?M--M----B?T-E--BMM?----B------B?o--o-----E?B-o--B?oBoM-?-
-M-?M---MTo-T-o?-?-o-Eo---TT-?Bo?--BTMoBE-B?M--?Mo??TM---MToo?T-BM---B-M|--ME--BEo-T-TBBBT?-E-?MEB----oT--?--oM-|---T---T?B-T-TBM-B--TT-M-----TMT-o---T--|-MM--MTBM-MBMMoE--?--M-T---Too-T-EMo-o?-?o----
m????M?--|--|-M---EBo-?o?-||-MoM-oME|E-EB?-E--EoEoMB|?-MoB|-oo|-B--EE-?o|??-?B-BME-|-|B-B|-EM----?oooB-|?-Bo-?BM|?oB|B--|?ME|-|M-o-o-||-BEM-Eo|-|-B---|M-|--E--E|o?ME-oB-??EEM-MB|E??|oM-|MM?--BEE----?M
XXXXXXXXXXXXXXXXXXXXXXXXXXXXXXXXXXXXXXXXXXXXXXXXXXXXXXXXXXXXXXXXXXXXXXXXXXXXXXXXXXXXXXXXXXXXXXXXXXXXXXXXXXXXXXXXXXXXXXXXXXXXXXXXXXXXXXXXXXXXXXXXXXXXXXXXXXXXXXXXXXXXXXXXXXXXXXXXXXXXXXXXXXXXXXXXXXXXXXXX
