-E--oB----BB?---?o-oEME-Mo-?-o-----oB-M--M-BB------BM-B??M?-oM-??E---B-?Mo-B--Boo-EBM-o-?--MEE----o?BM--B-BoME?MB-ooM-M----MB-BoE-----o-o-BMMM----B-M--M-MEBM-?M?-----o-B-M?-o----M---Mo-M--M?-----?--oo
------o---M--o?E-o----M--??-MoEB-?--Mo-B---?--EB-Eo-o-MM------M---B?M--?-?--M-EMoMBo-?M---?oM----Mo-MB--EB--oB----?--?E-M-o--o--BBM----?E-BBEEB-ooME-o--o??-o-o-BM------BB-MM-E??-?-B--?-B--B-E-B?EBE-oo
-?E-Mo?o-------B---?M---Bo-MMB-M-M?BEoB-o--Mo?---M-E--?---o----B-Mo-?M---?BE-?---B?-o-ME-ooE-?-B--oEM?B-M--o-MoM--M--o--M----?-MM-MM?BBMBM?-M-o-E---?Bo??o----B-?-E?------B--------oB--oBMo----oM??B?-oo
--B--??Mo--Bo-MB------?BM-o--MooBMEEM?-M-B?B?BM---EMEM--o-??E--?E--------oMMMoEM-M-MoMM?M-?M-?-?--M-?M?-?--MB?---Eo-EB--EoM-oMB--M-BBo--?M-M?--?M-M-B---BMBo---E-M-----ooM?-Mo-o-M-o--M-??-B------?-M-oo
MoB--B-?E-B--M-o---o-BB?--M??M--M-----?B-BoM--Eo?-?o-E--??-EB--B-o-o-MBE-BBBM?BMo?---?-M?MB--oo----BB--oEE?E-o---?--BoBBB?---M-?-MB-o---o--MM--B-E-?E--B-o-oo--?oo?BB--E-B--?-?-----?-B--B--M?B-M-EB--oo
?B---?ooMo--B-MB-?--B-oE--BME-??-MoBoEM?--oBoM??MMBB-?----M----o-o-?-oB?Eoo----B-oB-??M??-oM-BB-BEMB-o--M?M--B--o-?-o--?---?E--?B-oBooM----M---?M------M--o--o-E---M-o---o-o-MB---o-o-EM-M-B--B?--?ME-oo
----B-oMo-E--E-?---B--o--M?-M-Boo--B--Boo--?B---M?E----------MM-oMo-E-?M??B----o-EMMEB-oE-?--B----M--M----?-?o-M--B-?B-------??--oE-M-M--M------?M-B-o--------M-?--M-E-Moo-E-M-?-?-o-B?Bo--B-M-Mo?M---oo
M-o-oE----?--B-EBo-M-M-M--M-E?-o?-------M--MBEoB--?-oM---o-M-oMo?M--M?oE?----EM-MM-M---o--?M---o----Eo?-E-?--Eo-Eo-oo--BB-o-BE--B------o-ME--M-Eoo?o----??------o?BB-?-BME-------?-M-BE?E---M-B------voo
-?BM-B-o-?----o??-?B-E-B?BBBB-E?-Mo--M--o-------?---o-o-o---o--?B-M-oBo?M?EBo-?--M----?-Eo--EM?Mo-M-BB?----oBBo-?-oE?-B--?EB-?---EoBMo-?--B?o-B--?--??---?-B-?-Bo-M?M--o--MEo-o-MM--E?-M-----EB------foo
--M-??-?-B?Mo?-MM-M---oEooM?-?-E---B--oo-Eo?-oB----MBoE?oMB-E-?-EB-----?EM--o?--EooEEoBoBM?-B-B-??-o----?--?-M--B-o?oBo--?-oEE-EB--?------BoEo-B--o--E--BMo?-MoM--M--o---ooB?MoMo--??--B-o-?-B--?M--Mfoo
o--o-M?---B?--o-MBM--?M--M-oB----M-----o-M?B-MB-?-o-M-?-M?-BME---BBMMM---o-?--ooB--MMo--B--E--o----?M-?---B-??-B--BEo-oME-EEMM---??-oMMEE-ME--o?--?oE--?M?-M-BoM?BEooB--E?----M-??M--M-Eo--EB-E-----Mfoo
---?---B?Eo-B-B--?--o-E----o-Moo?M---Mo-MoMoBB-E?o-B-M-E--o-----MM?-MBE--MMo----EB-Mo---B--M-oB--BM?---M----o--BEE--??---M?B---?-E-M--oB---M?--o-oMMM--?o??M--MoBo------?o------M-?Bo-?---B-?E?oM-B--foo
-?oMB--MM-To-oE------?---?---o--oM--M-M?---o---BBBE---BB??-B-B?oM--ME-M--B----E-?-?B-Eo-?B-E-???---o--E--??M?B-oMBE?--B?---MT-ME-BMBo----o------B--?---?--o-M--Eo-BB-T-?o-B?B-B-?------EM--?-BMEB?-oMfoo
?-?-T??B-M|M-----BB-TE-B-oE-TB---?---?---BBT---T--T-BM?--MB--?EB---B?--T---oTEM-B-?B?BB-T---T-EMooB--B-M-MBo-oo--T-B-M-E?-ME|--BToT-M?E--?-o-E--MTMMoT--ooMT---BT-M-?|---E--T-T-?BEooB--B-EEM---?-B-Efoo
m--?|EBEEE|--oMEo-?E|B?oEE--|?ME-o?BB--M--?|B-?|BE|-M--E-BM-o---MM-o-oo|oE?B|--E--B--M-o|E--|EMEM-?o-?----oB--B-E|B-BoEBMo-?|o--|-|?-B-?Mo??--M-o|?Bo|-?B-M|-?M-|-oBB|ME-B--|E|oBE?Eo-EoBM???o--?M-E-foo
XXXXXXXXXXXXXXXXXXXXXXXXXXXXXXXXXXXXXXXXXXXXXXXXXXXXXXXXXXXXXXXXXXXXXXXXXXXXXXXXXXXXXXXXXXXXXXXXXXXXXXXXXXXXXXXXXXXXXXXXXXXXXXXXXXXXXXXXXXXXXXXXXXXXXXXXXXXXXXXXXXXXXXXXXXXXXXXXXXXXXXXXXXXXXXXXXXXXXfXX
