--------------------------------------------------------------------------------------------------------------------------------------------------------------------------------------------------------
--------------------------------------------------------------------------------------------------------------------------------------------------------------------------------------------------------
--------------------------------------------------------------------------------------------------------------------------------------------------------------------------------------------------------
--------------------------------------------------------------------------------------------------------------------------------------------------------------------------------------------------------
------o-------------------------------------------------------------------------------------------------------------------------------------------------------------------------------------------------
--------------------------------------------------------------------------------------------------------------------------------------------------------------------------------------------------------
--------------------------------------------------------------------------------------------------------------------------------------------------------------------------------------------------------
-----?---------------------------------------B-------------------------------------------------------------o-------------------------------------------------------------------------------------------v
-------------------------------------------------------------------------------------------------------------------------------------------------------------------------X-----------------------------f
------?-----------------------------------------------------------------------------------------------------------------------------------------------------------------XX-----------------------------f
-----------------------------------------------------------------------------------------------------------------------------------------------------------------------XXX-----------------------------f
----------------------------------------------------------------------------------------------------------------------------------------------------------------------XXXX-----------------------------f
---------------------------------------------------------------------------------------------------------------------------------------------------------------------XXXXX-----------------------------f
-------------------------------------------------------X------------------------------------------------------------------------------------------------------------XXXXXX-----------------------------f
m-E----------------------------------------------------XX------------------------------------------------------???????---------------------------------------------XXXXXXX------------------------E----X
XXoXXXXXXXXXXXXXXXXXXXXXXXXXXXXXXXXXXXXXXXXXXXXXXXXXXXXXXXXXXXXXXXXXXXXXXXXXXXXXXXXXXXXXXXXXXXXXXXXXXXXXXXXXXXXXXXXXX--------XXXXXXXXXXXXXXXXXXXXXXXXXXXXXXXXXXXXXXXXXXXXXXXXXXXXXXXXXXXXXXXXXXXXXXXXXXX
