-BMBo---o-oB---oE---MM-BM?E?o-BBoo-M-----B--BMM-??EMo-MBoB--o--MB--M??M-M--B?oM-E?M?--oEM---B?-MEE--??-oM?BM?-o----B?-?-?--BoEoo-ooE-E---?-?-Mooo-B?B??B-------?-o--?o--Eooo--?oE?o?BoM------o--o-E??-oo
oMM----o---M?----o---MM--o-?o--E-?M--M---??MMMMMB???---o-M-BB--B--??-oM-BB-B-Eo?-?B----M-o--oBB?--o--o-o?B--o?EM----?--?-?-?-?E-o-?-??BB--oo-B---?---E?BM?E?ME-B--o?o-Bo-?-M-???-o-B--oBoE-MEo-o-B-o?-oo
MMMo-?-?------B--------M-BM-B-M--oo-??E-B-?-o-oo-o-E-o-B?-B-B--o??-??--?o--o?M---BB-?ooBE--o---E-BBBoE-E--M--o--???---oMM---oBM--BEMMMo-?E-BoB-M??-Bo-Mo-B--BM-o-o?--oBB-M-oo-B--oo--?M?----MMEBM--?--oo
oooBoM--o?-B---ooMM-o-------Mo-oBB--?o??E?MEBo--oE--M?E-E-EBo--oooB---o--?E-EM---?-B-?--Mooo------o??-B--ME??M?-MB----??-??oo?ooEB--ooo-o--?B-B--o-oMMoB-Eo--oo?M---oB-BB-oo--o?-?BBEB-oMEM--o-o----o-oo
-ooEM?M--o--o-E--MB--M?oo--M--B?-------BMM?-MMB?BMB?ooB-?o?EE-oo?oB-o-o?-oM--Bo-M??Bo-o-M-E?-o-BBBM-E-oM-----M-?ME-Mo-M---MB?M-EB-oM?oM----BM---ooMEMo-o-B-?E-o--EBEB---B--E---ooooo--?-M?-B-?--?o-oo-oo
-EBB?EMM-B-B-?M-?MBo-oE?o--EooB-?o---o-o-?--Eo---B?oBMME-ooo?--BM-BB-o?ooMBBB?-E???M-o-?M-??-Bo-?M----?----BM-?--BoMMEB--B-?oB-B?B-oBoMo----oM-??oM--ME--B?BB???B--B--?o-oM-B---M-?M-E?oo-M-?---EE--?-oo
-BB--BMo-?ME--BE-o-oM?M-B--MM?E----o---M-?--?EM---MMBooMo??-Eooo-?-oM--o--ooMo---?-oMM?B-?o--?-MBM-oM--o-?---o--B-M??ooE--o---B?--?M----o-?-oo---MB--MMo--o-?-M?E--o-?B---Mo-------MM--M-BM?-M?--B-MM-oo
-BE-B-?-B-MBo?-o--EM-o?o--B?-BM-Eo-?-M-?B?--?B--Mo---M?oEB-o?M?oB?--M-o?--?--BMB?o--B?oB-E??oo-B-ooM?-E-Mo?B--o-?M???o--??oooB--M---BM-??MM----Eo?o-B-MM-E--M-------o-BB?B?E-?-o-E-E-----Mo?B?o--o-B-voo
o-MoM-E--oBE-----o?-M-M---BEBo-oM?M-oB?Eo-----MBo-oo?-o-B-o-?--??M-oM--?BB---BoooMo?-BB---EM--o-E---M??B--Eo?--?--??-oM-??--BBBE----??Bo-?ooB-MB--oo-?--MM??-?----o-?---EM-?-----BM?-MoB-??o-?---EoBBfoo
oMo-M?---??---B-o-E-?oEo????M--B-B?o-?B--E?-M?--??-Moo-E-?-EM-MB-?o-E-?oM-E-EBM--?oM----Bo??oBBM---o--oM--B?o-oMB-M-M----?--ME-?oMBM-?E?BB---MM-o?M--B?-BM-B--M-Bo?o----M?---o??M?o-EBBB?MB-Eo-B-M-Mofoo
?--?---?-o?----?E------?-Bo?-M-o-?-?M--E-BBB-M-?B--o-o-?EEM?--Mo-EBM-o??o?M-BooM?-o-E-BE??Moo?-o-o?-Bo-?o-E?--o-E?Booo-B?E---M-B?oEooB--B---o?-?--------M----oM??B-EE-BM-M?--Bo-o-o--M---B--??-M?-M-Efoo
M-o?MB-ooo---?---oo--oo--ME?-?--M--M---?o-ooMo-Mo-oB-o-??B-M-M-----MEMM-E?BB-M--oM?--o--M--oE--o??--BooMo-M-E?---B-?-?-Mo-oB----?-?--E-BE-B---??MM--BMoM-oBo-B-MMMoM?--M-o?---M-?M?E?oEoo?M--MooE-MEBfoo
---ooEo-MEB-EoMo---Moo??Eoo-B-B?B?o-o?oBB---M--B------oB?-oM?o?-E?-?MoMoMoo-?o-----B--?o-?Eoo?oM-B---B--M---o-BoB?MBo----?MM--o----o?M?---B-B---E-oMBMBBBM??--o-MB-o??M-oM-E--B?---M-MBM?-oo--M???o--foo
B-M?----EBE---oB---?M--oM-?--?oMo-M--M?--o-----B-??B--??--?oM-B-----o--o--MoE-?B-BB----?-E-M---o-E--B--EBo-oM--MB?M??o-------o-----B-?oB?-?-E?-oM?Bo--E--B--B-?-?--E-?-oo?B-BE??--?o?oo-?--E--?--M-M-foo
m----------------------------------------------------------------------------------------------------------------------------------------------------------------------------------------------------foo
X----------------------------------------------------------------------------------------------------------------------------------------------------------------------------------------------------fXX
