BM?-E?--oo-?B--?----o?ME--B-oBEM-EBEM--M-BE-?----M---oM-o------o-o-BM-E-o?-oM---M-?o---o--M----?-M-o?-B-M-B-----?---MB---oB-M--BB-BE-B-M-oo-----M??---E?---oBME?-----E--M-M-M---o--o---MB-M?-B-----M--oo
--MM?-E--?--BB-?o?-M--oB-----BMM-B---oo---?oM---o----M-EMo?-o?Bo?--B-o-M-----oE-oMM-?-??-M-oE-B-ooE?ooMoBBM-?-oE?ME--EM--?o--BB-M---?BB--oo-MooMM-E-oM-M---M---??---o-E-oo----E?M---EBEo-B--o?--E-----oo
-M?-?-ME--B?B-o-?BM--o----E?o--BMM-BM---?BM-M?MB----M?oM--?BB-?---oM-?-MB-----M----B---o-M-E--o-oo?M-oo-EMB-E-MME?------Mo?--oo-E---o--?E-?---M-E---MMBBo-B-M-o---?B---MM-BE----oEB-B-M--?EM-??M-?-B--oo
-M?--o--o-----MBo--MMo--B---M----E-BM?Eo-B---E-BMME--B--Eo----B-M--?---B-o-B--B-Bo-MEE?-E---M----B--B-o--BMo-E-MM--?--EM-M-o----B---M------B-o--?-Bo?-B---MMoB----ME--E-?-?B-?-?o?-BM--o--BM--EB-oM---oo
?-M?EBB-BM-o-BM--o--?MB?BoMo-M---M-B-oBB??M-??--o----B--B-o?-B?EM----BEB-Eo--oM?---BMB-?-ooB--B?--M---B-BM-?-B-MEEE----B-MB?--B----BMo--Bo-M-o---?-oMoM-?MME--B-E-E??--o-o?-o?M?oEE---?Eo----oBoE-oBB-oo
ME-?MB---M-?o-----E-M--EoE-?o?-?E?B--B??B--oo?---o-B----oo-?-M?B-?--M-BM-BBEo-?o--B?M-o?-MoB--B--B--B--o-B-EoBE-MB?-M---EMMBEo??-o--?-o-B-M-?B-Mo---B-B---M-----?o-oB--------B-o--?-o---MM---MM--o??--oo
------oM---??B?MB-B---MME---B?-oBBo-B-E-ooB-B-oB--E?---B---oMMB-?-??-M-BBoBM-oMMB---ooo--BE?-Bo?-o-----?o-B-o--MM?-?--M---o---?-Bo--M-?-M-MMMB??M----M-?EB?o--o?oo--B-o?-o?-BM--BM--B?o-E--M-M--BMB---oo
M--o--B--?E-?M-?E-MM-M-BM?M-EMM---M-E---BB-B?B-?o--B--M?oMoo-BM-o-?-B-o-o-M?M-?---o-------?-BB-?M?-M---EB-EBo-EBo??-MB-BE--o-?--?o---M-B-o--o?--o-o-M?-?-EMB--?oMMBBE-oBM---M-MB----o-?----?MB--oMEB?voo
M--B----MM?oE---Bo--?-M-M--o?M-B-?--B--BM-?M--M-BEo-M-o?B---Bo-?--E--M?M---o-?-o?-B-?-MEMM----o----Moo-M---?-E-?------M-?-MMM-o--MEB---o--o?---E-?M--?-?--M-o----o-E--?-ME--B--MEE-oME--M-BM-?EE---?Bfoo
M---Eooo?oBB-MooM--?B-o-E---o-ME-?MM-ooEoEM--EMo-BMoo-MEB?-----B---B?--BM--E-?-o-???--o--E--B-----E-Eo-?o-o--MBM--?-BMB-MB---E-?-M-M-E?-oBB--M?BM-M----?M-MBBE?--B----o--?-B-?oB?B---?B--EoMo--?oE-oEfoo
-M?BMBo-?o--B---ME--M-----E--E-Bo--MooB--?-?MB?---M--oo---Eo-M-o-MMM?-M-o-B-MEMMM------?E?B-oMo---B-M?--?-?-----o-EEBB---o?-BM--?-----?oB-M-ooB--B--M--Mo-EoB--BM-E-o--M?B-BoME-E??BM?-o?B-M--M?B---Bfoo
oo--BB-?o-MMoBBoEB------MM?B-BoM?-o--M----M--Mo--E-ooMoE----E?-B----?-M-B--BBM?-?-----?o-E-B?o--oM-?-?-MM-----B?B?---M?----MM----MEo?E--BoB-?-?-BBo??--M-o-oo?---o-?-o---BM-------MMM???-o-E-B?-?Bo?-foo
B-M-?-o?---BM------B--oMEEB-?BB--BMMB--BE-M-oB??--?--o?M------E?--EM-E?-?o-M-?o---MB?---E--E?MMEB--?-E---oE--B?-EB-M-o?oBE?BB-EBoo?E----oBo--EEo-E-MB--o---Mo-B--M-ME---E--M--Eoo----M---T-B--B----EBfoo
oMMo??o-E-E??-?-----EoBT?-?B--B-T-??E-E?-B?-T??M-?BTE--T---?TMTT?-TTB--M--?E??---TE-T-EB?BT-?oo-M?-MMBoo--TE??oET---ETMBM??oBMBB--TB---------BM-M-ME-TBoMoBT-B-MTMTBTEo-----MM---?--M--T-|o--o--T---?foo
m--?-E--?-M--EM-?oEMB-?|?--E--M-|-o?--Bo?EME|?o--oE|--B|-EME|M||-?||E?MB--?B--?-B|M-|--MEE|E-M??EMBBM-o-?-|-?--?|M--?|?-EBE--?---E|oMo---EM-oM--E?EB?|B-E-o|-o-B|-|-|?E-Mo-E-o--MBEME-o|-|B-oM--|MoB-foo
XXXXXXXXXXXXXXXXXXXXXXXXXXXXXXXXXXXXXXXXXXXXXXXXXXXXXXXXXXXXXXXXXXXXXXXXXXXXXXXXXXXXXXXXXXXXXXXXXXXXXXXXXXXXXXXXXXXXXXXXXXXXXXXXXXXXXXXXXXXXXXXXXXXXXXXXXXXXXXXXXXXXXXXXXXXXXXXXXXXXXXXXXXXXXXXXXXXXXfXX
