EBB?o-BooE--?-M-----?B--o--E--oMB---o-E-oE--B-o?--?-M---B-?-B--M-BB-oMMoBBE----?o---------M---M-o----E--oBB-Bo----o-M--B-E-E-EM--?-EooB--E----B-B-B---oBB------ooMM-?--M-??Mo-o-ME-MEM?-E???o-?o---M--oo
?--oM--E----?EMM-o-o--oB?-?-ME?--oM--o--o--Mo---MBB--BE--o?--M------Mo-E-oM----MBBEBEoE-?--M-E---E-B-B--M?--B?----?-MM-BEM-B-M-?--BMMEB?--B?-oo--oBoMo-?EB-?E-M---?-?-?--o??--o-?Mo-M--B---?BoB-oB----oo
-?-B?-?B---MM?-?--Mo--B-oBM-o---BB?-M--M-M--B-EoE--B-B-E-B------oE-o--M--M-------E?B??---?E-?-Mo?-??M-M--EBEBM-o-?Bo-B---EB-M--?--------oo--M--E---BB----MM-?-B-MB-oE------?--Eo-o??-E-M--o--oo-?-----oo
--o-------MooM-?o------E-?B-E--oBM--?B?M---MM--E-B--??-?--Eo-oo---E-?--M-B-MMME?---M---Eo?--?-o----B--BoM?-??B-oE-----EB--E-?-M---B-M---BE---M----?B-?--Mo?--o?MMo-E-?BoEB--M-?M-?-?MBo--?o?----EoBEo-oo
-o-E-E-o---MME--o---?---BMooMo-?---?o?-ooE??-?-Bo-?-MB----?-B-o-BMMooEMM-EB--?----o?-o?-?o?-M-E?M-E?-ooMM-?M--B-M--oo---???BM-o--B-MM-EE--?o-B-B--MB-o--B--B---?oB-M--?----?o-o-M--?M---?---o-?B-o-MB-oo
o?-BBBM--B--B--o-BEo-B-?B-o?--EoM---B-----oBEE--B-M---?E---?BB--B-Mo?-o-E?EE-oBoE-EB?--B----E-ME??---o---B?------Mo?--EBo-M?o--E--oB---?B-B---Eo--B-o-oo-B??o--o---M---ooo--BMooM-?-M-?oooEM--Bo-o-M--oo
---oM-o?B-MBo-ooEMB?Bo--EoBM--B-M-B-o-?E?-o-MB?----oMEo??o----MoB---MMooMM---B--M--E?M-o?o--M?-B--oMMoo--M---------BB-B-EM-----Mo-o-B---E?-o--B-E---oE--E-M?M-Bo-BB-----B--MB---BE-MM--?-?----?o-?-EM-oo
oBE-MM-B-MoM?--?MB-Mo--?B-?-??B-M-E---?---E--??-MBM---M----o---?--o-----o---B?M-BE--------?M?---o-B-?-M--oMoMMM-M---B--B?--B--B?B-B---BB--??M---?o?-?B---B--EB----M-B?-?--M-?Mo-E?-oo--o?o?-o-EB-?-?-voo
oB-?oB?-?--M?-?-?o---oM-M---M?-EB---M-?M-oBMo----M-BEE---M--E?-----oo---??M-?oM-o-?-o---BB--MM-?--?E-E---M-B?--?Mo--E-?-?-MB?-Mo-?----?Moo?B---?---M-M-----MB-oB--B--E?-o-Moo-M-??-o-Mo?BM-oBo--M-oBMfoo
M-M--ooB?BM--?B-?-M--?--?-MM-B--o----M--oBo-?--B---oB----oMo--??------Bo--o--?M-?B----?-M-oo?ooE-B-BB----------BE-E-BB--B??-o--o---MEM--------M-oM-o-?E--?--B-oME---o-EB-oo---?---o-MBM?----MM???-oE-foo
---M-E---B?-??BMB-oo-------oM--?-?---o?o--B-oooBM?--o-?-EEBoo-o-B-?-?o-o-Mo-?---BB---MoB-------?--?M-o-M?--o---E-E?o---?--ooB---B?M-B----B-o?-E---M-?E-MBBMoMB-M---ooMB-o--MoE-Mo--E?EMo-o-?--o-oooBBfoo
-o---B-?--BE---E---B----E-MM--E?EMo?-E-Bo-?-??E?B---oEEMBM---MoE??o-M-oB-E----M-?B-EB?-M?B--EMEB----o-M--o--EE-----B--?MB--BM-o---M-o?o-B---EMB-M--Mo-??oM--B-oE--?ooB------M---B-M-E-E---?---?-BM---foo
-MEMoE--EM?---BM-ME--?-B?M--BMMoBEB-?MB?--?o-M?E?-o-oBMM-o---?MM?E-?-o-Mo--M---MB?-M----M-oE-M?--M-EM--E--M-B---M-MBo-B?M-MME-Bo--Bo-??M?oM-MEB-M-B---B-B-BEMMEB-?o-M-?--M--Mo-ME-B-M--?E?-BBo-BEEM-Efoo
-o??-B-EBT------ToB-M-M--o?-BMEoT?oT-----MB---o??T-----?--?To-TMo-oMTTo----T--B?oTo----M-EMM---TE--BooE?-M--ET?BBE--E-MT--M-?Eo?--o--MMToTT-o-B-T-M-oT?-T-----B-TE-?B-M-BoBE----MoBooT-E---o-M-T-M?o-foo
m-MM-B--E|?E-MM-|oB-?-EE?-EM-MBM|M-|o-M-Bo-?Bo---|oE--Bo-?o|Bo|o-EBo||-o-?o|E-BM-|-BEBM--Mo-BM-|B-?BE-?BMM?BB|-Mo-?-B?B|o-oMMB-ME-M--EM|-||M?--B|BEMM|?-|-??-E-M|??--M?BBE-B---EEo-Mo|-?E-o-o-M|oo-E?foo
XXXXXXXXXXXXXXXXXXXXXXXXXXXXXXXXXXXXXXXXXXXXXXXXXXXXXXXXXXXXXXXXXXXXXXXXXXXXXXXXXXXXXXXXXXXXXXXXXXXXXXXXXXXXXXXXXXXXXXXXXXXXXXXXXXXXXXXXXXXXXXXXXXXXXXXXXXXXXXXXXXXXXXXXXXXXXXXXXXXXXXXXXXXXXXXXXXXXXfXX
