-BMM-E---o-o-oo-ooEM?---Eo--oM-oo-?E--E-o------?MoB-oB-M-BoE?-Mo-E-Bo?-?M--B?o--EM---?oo?M---o-------oB---o?-oo-?BM--oooE-BM-M?-----o-?E--M---Bo----E?-E-MoE-?E--??--E?-BE-Eo-?---o--E-B-oE-E-o--M--o-oo
--MM-M----Mo--?-BEB--o?--E-Bo?-E?-oM-B----oo-?o-o?-Eo-MB-E-?EE-M--oBo-?------o?EM-o--B------M-??--?o--oM?E-----o?BB---MB-B-oBME--?----?Mo?M---EBB---?----o-B-----EB--?---M--E--Bo--M-BMMB??----E??----oo
-----?B--M?-------------B?----BB--oBEo-M----?------MM?--B---M--B-MB-Boo-Boo----?--------?-o------BM---o?-B-o-M-??o?---oB-MM-B-M-BoB---?Bo--MBoMM-?o--E?--?M-o-?Mo??---?-B--BB---??E-o??BMo--oooM-oM-B-oo
--EB-oo--BBo-o---M-E-oo--?-o-EoE---B-?MB-Mo-?o?---ME-M-oo---------M-M-E??M----MB-ooB--M--MoM-oB-o-E??B--E---?M-o?M??-ooM-?o-B?B-------E-BB-Mooo-BEM--M?-E-?--oEME---oEM--BEBEooBBM-oM-o--M----E----E--oo
--??-M---B??o??o-B-MBooE-?--E----o-oBM?--E-o---?-B--EB-oB-M-MMoE-E---M-BM-??o?E--o?-oooo--oE-M--E-?-B?--M-M--oM-oB--B--M--M-oE?-M----MM------B--oMB?---?-o--?M--BE?MB--B-B-BM-?E--B-oE---o--M?ME---ME-oo
-o-?-B-BM--EMo--BB?M?---?o--BBo-?-Bo--E---o-?o?-M-?--?-----?B-?MB-Mo-oM-??Boo-M-ooB-o-oBBoEME---?-E-oBEo-o-EMBBB--M-ME-M--o--??-E?----Mooo---?-?-B-o?M-EMM-o-BM-?Bo----BB--?--??--E--Mo---E---M?--???-oo
-M?MBo--B-E?-MEE--M---?o?--Mo--M-?---E-EoM--o-EB-?--o--Mo-B-M-B--B?-B----M---oM?B-o-o-?--??MM-?-M--M-o---MBM-??o?--B-MMoM?---B--ME-M-Bo----BEBB-?MMM?-MBM-?-M-oMEE---oB-o-BoE----??BE?M--M?B?-EE--oM--oo
BBE-EB--EM?----B-o--B---o????-E-?BoBBBoM----?E-MMMM-?o?---o---M----Mo?EE-B--M--B-oBEoMo-o-?MoM-E?EM?Bo--BBE-oo--?M------??o-MM--o?-B---?-o-MB-?---BoM--?B-?-M-Bo?M?----oM-MMB?EM-B--?ME-----B--?--o-Bvoo
Bo?o--B-?--oB---MMo-oo---BMB???----MoE--?-E---?BM--o?BoB-BE--o---o-M--?Bo---BoB--?M--?-?o-ooMBoM-???o-MooM?E--B-B-?-EME--BB-MMo--o-Bo---o-?-oM-M?B?-?--BM?o-----M-M-BE--?-M-?-?B---------M-o---BoM-B-foo
o?-B---o-o--M---o-MME-oB?B?o-EoEMM-Eo?Bo--B--Mo--?MM-E---BM----E--Mo-?--Bo--oM----EBBBo-ooME-?----M-?E-----?E--o--?---M-?Moo-EBE-B-oM-oBM-BMM-M?BEEB---?oB--oBoEM?---B--oo-oMM--EEB-o-ME-o-M--M--B---foo
--Mo-M--B---o-BM??----oB-EMBM?oBo--B-----oBoE-Bo----BMBBo?MB---BM?MEo-M--B-M---?o--??-BMB?-----??-M??B-M-oo-BB-M----E?oB------o--M?-------o------?----?----?E--?B--??o?-BEBMM---?-MBMM---oBB-EE---o-Efoo
----B?oo--MB?EM--?-o---MM?-B-?oM-E-ooME--??-------E-?Eo-o---------MBo---o---ME-----B--?-BBM?ooo---------BB----?----o--?-o?o--EBMoM?M?-?---B--ME-oM-EEo---MBM?--?oo----B---EoM-?---E--MB?----?BM-M---Mfoo
o--B?-M-o-BM?MM----o---o---o-M-B---E?--B----------??-?-BMo------MT?--BEo---E---M-M--BE?-M-oo----ME?M--o--MMME-BMMoMM-?o--?-ME?o??--T--ME-EB--?BEMo-?BBB?-?-M-EEo--?-MB?--EM-ME----B---o-?---?MBo----Bfoo
MT--Moo?E-ETEoME--M-T-oTM---ME-ToT-To-?-M---MBBB?---MoT-T---o-BBo|--oo?T-TEMB-B?---TBTB-B-E-MTMoB--M-Eo-?Mo-Bo?oT-oM?BT-B---B-M?M?o|--?-MBT-TT??--BME--T---TE?MM--TBT---?M?-TM----M--oMT?-oM---?----ofoo
m|--M?E--B-|?oo---o-|-o|EB--EM-|?|-|--BoM-?-MB?BE-oB?-|E|-oE-E---|---EM|?|BM-M-oMoo|?|-o?--EE|---o---Mo-MB-Bo-M-|Bo-oM|MM-Eoo-M-o-B|-M-?B-|o||B-?M?-?E-|?EE|-EM-EB|?|B?EM---|B-o?o-BBM-|?E-?EB--E---Mfoo
XXXXXXXXXXXXXXXXXXXXXXXXXXXXXXXXXXXXXXXXXXXXXXXXXXXXXXXXXXXXXXXXXXXXXXXXXXXXXXXXXXXXXXXXXXXXXXXXXXXXXXXXXXXXXXXXXXXXXXXXXXXXXXXXXXXXXXXXXXXXXXXXXXXXXXXXXXXXXXXXXXXXXXXXXXXXXXXXXXXXXXXXXXXXXXXXXXXXXfXX
