--EEo-E--o--B--oB--Mo-----B-?B---B?-----BMMB-oM-----B-B---Eo?M-M?B-?EMM---o?-MooB-M-o-E-oBE-----?o--o?----B---?-oEMMo-o?-BE-BE----BBM--B-o-M-??--??MoEo--?-E?-oo--BM-M--BBBE-MM---?MBEMM---?-o-MBo-M--oo
-EB-o-M----??---BBB-o-B---B??B---?E-B---?-BM?-oo----M--B?B----M?---???-B?oM--E?-Eo-EB-M--E?-B?o-?-E-?B-M------Mo--o-?Eo---MoB--?o---B---E-MB-----BB--?oo-------EB---oE---BoB?Bo-B-oMo---Bo?-?oBME-B-M-oo
M--B--M--o-B-EM-oM?BEo?----?----o-Bo--?-Mo-----BB-?-Boo-Bo-MB---??Eo-o--?EB--?MM-?M-BB---B--MoEo?-?oo?-o--o?-MoE-o-M-MEB-?--?--o-EBE?------E----oMoMM---oo-BMo-BM-o?BB?-oM--oB---o-oMM?o-EMMM-?-------oo
o-o------Mo---o---?MBBM----o-M--ooo---B-----M---MB-----o-?-?---?o-B-?-B-M--o-Bo-M-M-?MMEo--oM-?-?o--?Eoo--?-MM--?-----?M-B--MMo???----?oM---?--MM-----oo--MM--o?MBBooM-BM---EB----E?ooM-?B--?-o-MM-o--oo
?-?---M-B---oM?MM-??o--?EB--Bo------?Bo-?oMo--EEM-o-o?--oBooEo--ooo-o-E--MB---EBMo-M--M--?-oB-BMMM--BBoo-?---BEEBB----oEB??EE-o--M---B--EEo?oB?--MM----?-?-?-----B---ooB-E-o-?-o-EB-B------o?-----?---oo
ooo--E---------M---MB-M-BM-M--?E-----B--?----B-M?o---M--M--MB?-?BB-E-oB-E-M-ooBo----BoB?Eo-?-EM-o--Eo---?------B??------BBo-M--E---Bo-o-M-MM-oB---ME-MEo-B-EB---?---Mo--oB--?-E--B-B-ooE--BB------M-E-oo
--o-?M-?---???EEE--?o-BoMo--o--?---?Mo-MB---B---o---o---B-?E??M---M-M?-MBo----------?--o-o-M?-?--MMM--B-?-?-----oMoME-E-----oM-?-?--ME-o-oMM-M----?B?-?-oBBM-B-EoEME?-E-BMoB----EB-----B?B-Eo-oooBoMB-oo
-?M-B---EE-o-EBM?Eo-BBo-BB---o--B----B?---Eo-?B--B--EB-oM-M--?----?-BoBBoE---?M?-M-B---M?-?-B-----M-oo-E-?----o-E---Bo-M-ooM-?MBMB----?o--o-M?----BM-M----B-Bo-B---B-?--M--B-?--M--?EB--oM?Bo--E?o--?voo
-?M---EM-B-BEBBo---B-oE-Mo?BB-MoB-Bo?--M?oM?-M-?o--E?-----oE-??o-o-ooE--------o---?M--BB??--BB-------BB?-?Bo-oBBBo?-M------o-Mo--?-oEEMB--Mo--E-??o?-M---M-M--Eoo-o-?E--M-MEB-E-M---B-?--o-?E?-B--MB-foo
-BoEBMBB-M-MMo-?-E-??o?-----o-?-???-?B---?--ooo-M-----M-MEM-o----o--M?B?MM-MM?MEM-Bo?-o-B-BB-o-M--o--?E-M----o-----?-----E-E-EE-M----?o-oEB---MBB-Mo?--E-E-o--B-??oEo-----M----M--M?-M-E-o--?-?-o---Efoo
M-E-?-?o--B-M-BM?MEEEB-B--o--?---oo?---?-M?-B-?-oEMoM-?-B?--?EMo?-?BoB--B-??--?-?M--M--o---oME-o-MoMB---?-----M-oM---E-oM-M-oM-?BB?B----?-oM--oMoE---B-?B?---oME-?-MMoMoo--oB-BBEB--M-??oB-----?M--B?foo
?EM?B-E-oE--B-oM-----?--?-Bo-B----Bo-B-Mo-MMBo-B-ME-M-EEB---MB??--MEM--o--?---o--B-oMB-o------o?M--oM---oB---oMMo--?B--o----???--E---BoB-B--B-o-M?M-ooo-M-E?---M-MMooo-E?--oM?---B?E-MM--MB--MBo-Bo-Mfoo
-?M?M?-oBMME--??E-EM---o-?M--E?-o-M--o?E--o-B---o-MoE-T?-?-o--M--MoM-M---EM-?M?-E---??--ooB---M----BE--??BooEB-Bo-oBo--oB?Bo-o----BMM?------M-oMEM--BEoE--M-M-?o----o-oMM-BEoM----M?--M-EEB------BM-Efoo
--B-M-EM?MB-E-?-M?MB-ooT-o-T--B--T?ETM?-TMT----B--o-BM|-E-M--oB-?BMT-oo---o---M?TT-?-MM-BB--?o?----MBE--Too--B?M?M--TM?-M----oM--------?-oM--TM--B--M?----M-B--Bo--?BM---M?BB??Eo-o-EooTTM-T-T--B-EoMfoo
m-Eo--B-EM--MMMBoB--EEo|M--|--?--|MB|?E-|o|oME---?-B--|BM-E--?oE?-o|-M---E?E-?-B||E?M--EM-EoBBMEoE-BMMoo|E?B?E??-oBE|?MBo?------o-----BMB-EEE|E?E--EM-Mo-E-M----Mo-M--oB---??B?--E-E-Mo||B-|-|MB?B?MEfoo
XXXXXXXXXXXXXXXXXXXXXXXXXXXXXXXXXXXXXXXXXXXXXXXXXXXXXXXXXXXXXXXXXXXXXXXXXXXXXXXXXXXXXXXXXXXXXXXXXXXXXXXXXXXXXXXXXXXXXXXXXXXXXXXXXXXXXXXXXXXXXXXXXXXXXXXXXXXXXXXXXXXXXXXXXXXXXXXXXXXXXXXXXXXXXXXXXXXXXfXX
