?-o-o-?oB-?-B-ooEo----o-EEo-?-M-MMB-EMoM-o-----MMMMBoMoM?----BM--------BB--o-B??--?BM--M----oM?----BMM--oEM--M-B-Bo----?o-E?-o-M-?-M-BoBB--M---B??BB---o?--BB-M-?BM-M-?M-o--o--EMB--?-EM--B-M?--??o?MM-M
----o?--?-BBE--?-?-E?o---MM-?MM?--oMM??--MBMM?MoB?E?---?-M----E-?----MB--------??o---oMBoo---M-EE-B--M-B-?M-E----?M-oB-MEE----Mo-?-M-E--o--B-----E--E---?--?-o-----BM--?--??---???-M??BMoE--M---M---o-MB
--MEo-E---?o--EMBM-?-oEE----B?B-M----BM--B--MM-B-?-B--BE---oM-M?------B---E-M-o-MBE--?BB---M-?-B-B??o--oo-BMMBB--?--M?B-----MM----M????MB?oBBE-----o-M-MMB--?----oE--o-M-oo-----MM?-o-oo--BEo-o?-Bo-B?-B
--oB----B--?E-Bo--E-?-B-?BoM--BBoo---M-?E-M-M-Eo-EoBE-MM--?Bo------B-B??-o--M-MoEEBE--oB-oo-EM--M-M-oME-BB----E?-?--EM-?ME---E---?o-??-----Mo-o----?---E-?-oBB-MEMBB-?-o--EM??----?-----oBo?o-Bo?BB-B?--
-o-?-BMBBoM-BMB--B?Eo-oo-oEM?--o-?--oE?o?EM-------oM---B??-oB-----?-MM-?Mo-oo-ooM?-M--BBB--o--?B-?M-o--M-BoB-o???B?o----M----?B--M?----BB---?-M--B---B--?-BMoB-oB??-M-M-ME-MoM-o-E?-M-M--oM??--B-----B-M
-M--B--o----E?-?-M-?--?MME------BB-M-B?-??-MBM?-o----?M-?M-E-oE-MB-----EB-o-M-?M-oo?--?B-o------Mo---o---?-ooBoBBM?--M-o---?--------E--M-----------o-Bo-E?--B-?M-M---o--??o-o?----MEB-Mo-BEMooE-------EB
oM--B-B--?MMBM-BBB-o?-oMoB-o-EM---?oBo--??---BBM--ME---MoM---B--BM-E---M--o-M--M-?--o----MoBMo----o---EB--?M-o--MM-M?--B---M-B?B?--oB---?-M-B-oEo----M-o?BM-o-EBo----Bo-o--M-o---o-BMBMB?EM----M?-Boo-Bo
M?Bo--o-o-M?MMM--o?-o?E-?E--E-EoE-B----M-E-oo-o?--?-oo-BE-oBo-E-o--?--MB---M-------B-M-o---?--?o?o---B?-ME-EBo--M-?Mo--oo----?-B--EEBB-BE---o-?BM---??-?--?--MBBMBoE-B?-?--??----??-M--M-?---B-M-B?----v
?Moo-Mo-??M-o?-???-M-BM-?-E?MM?o-???--??-M-EB---?oo-o-?MB---o?B--Bo?-B-M---?------BBB--EMEEMB?oo?o---E-M-B--BE---M---?B-M-?-oM-?--M--o-E--??---E?oE--?-?--o------Mo-o-o-B---oM-M-B??-B-Bo-----MM-oM--MB-
EM?------BMMo-MMM-o---o-MB-M-?--M-?-oB-BM-?ME--MB-?EE-M-?-----??M-oo--oB--E?E--E-o?---?--?B--MoE--Mo??-------Boo?-?-?-?-oM--E-BMMEoo--E----?-M-M-oB----Mooo-EE?---o?-o-B?-E?o-----MEo--BE-?------E-E---?
M--E-EM-o-M-oM-o-EBEooo-?o-Boo---oM--oE?-B--M-M----B--M-B?-M-M?-E--??-oB--M-B---?B--BooM?-ME?Mo?B-?M---?--?o--EBBBoB--B?----??-E??-o---E-??--B----M-Eo-?-B?-?-------------B--B-BBoo----o--E?Bo-o-MBB-M-?
-B---?--M---EM-o-B?MoE?--B--oB--E--M-o?-?-o-MB-o-B--M-oM----o-Bo--o-o-oooB-o-B-M--?---??--MM??--o---?---E-Mo-?Bo-?o-B-ooo?--o----BMMM--MMBM--M-EBB-M-?-?-M??B?--B-oM-E-oM-BMo-?-o--?M?-?B---M----M----E-
-?-o--MT?MBM?E?E---?-B-B?M-E?o--T----oo?E--M--E---o-?---B-?--M-??----E--EM?-B---M--o--M-o--?Eo-Eoo-M--BoME?M-BMBT-o----------?B--Eo-Mo---TMB-?B--E-?-o---??-o------EoB-B---?-BToE---Mo?o--M---?-E--M--T-
-MoBo-B|TMoBT---?-T-E?-oo--MT-T-|?oBMoE--?B-oT?oBM?------ooMMBT-ETMT----T--o-?B-MB-To-o--?---?M-?T-oo-T-T??--BBo|oo-----BE-T-oB--B??--??E|-T--BooM----T--o-Mo--oo--B-Mo-o--E-B|T--oo-T--MB----T-M-?-oB|E
m-??oE-||M--|-Mo--|E??M--BE-|-|-|--?-M?---oB-|---BE?B?-BM-BM?-|MM|-|--EE|BM-M-B--E?|-?MEoMEM-ME-M|EBo?|B|--Mo-B-|?E-o-B-B--|E--o?--oM?oB-|M|-o-MoMM-MB|?MBB--E-E?-B--MBo?B?-oM||B-EoB|----?--B|o??--BM|B
XXXXXXXXXXXXXXXXXXXXXXXXXXXXXXXXXXXXXXXXXXXXXXXXXXXXXXXXXXXXXXXXXXXXXXXXXXXXXXXXXXXXXXXXXXXXXXXXXXXXXXXXXXXXXXXXXXXXXXXXXXXXXXXXXXXXXXXXXXXXXXXXXXXXXXXXXXXXXXXXXXXXXXXXXXXXXXXXXXXXXXXXXXXXXXXXXXXXXXXX
