--B-ooooM?--BBoM-oo--o?-B-?--M?M??MoMo-o--????o----MM-MMM?Mo---MB--o--?o-?B-?-o-?-E-oE-oM-BoBBMooMo?EBM?M--B--o?--?oM?B--BM--oMMo?E?B?--?-----EM?-o-B?-?M-oM-MooBo------ooo?oEM--Bo?B-M------oo-o-E??-oo
o-?-oM?oMo-B--B?--BB-?-?E------Eo??E?B?o-Eo-BE---Mo?M-???B?-o?EB--?----Eoo--o?-B?-M?-?oM-?--o-o--?MBMMooo?-BooooE---oMBBo?-?o-oo--?--Mo--o-?-MMM-MoB?BM?EM?oM--?o---B-?BooBBEMMB?o-B--oBoEoMEo---B-o?-oo
B??M??-?-B?----E-B?-EBE---EM--B---?-o-??oB-oM-?-oo-?o-o??-o---Mo??-Bo-o?BoEB-o--oBM-?-BMEEEMoBM-??--E-o-o?oo?oMM?M-Boo??-M-oo-??Eo-B--B??oBoMo--Eo??o?--BBBo?o--?o-?o---E-?oBM-oM---??M?----MMoBM-o?--oo
---?-?Mo-M?Bo?BoEE?BB---E?--oB-Eoo--B?-o-Mo-Mo?MEooo-oooE-BB---oooBB?oBE-?B---??oMB-B--oBMB-MM-o?EEo?-M-?BoooEo?M--?-??-?M-o-o-----?BBB-?MM-o-o--o-?oo?o-BBo-o-?o-M?-??-M?oE-E-oE-BBEB-oMEM--o-o---?o-oo
??ooBBM??o-o--?-M-?E-?-?BM-??-??-oM?oo??E?-B?---M--B?-E-B??----o?oBM-o--o--???o-?-M?M?o--E-E?-E-?M??o-M--???o?o--B-MM-EB-?--ooEM---o-?---B-o-oBo--?-o----?-?--Moo-?-?-EB?E???M--?-oo----M?-B-?--?o-oo-oo
--?oM---oMoo?-?---??oBo-oBoB-M-B-o-ooo?--oo?oMB-?o-oooo---MB-o-BM-B--??-ooB?--?Bo-?MBM?-o-oMM-B?-oE---BEoo-?--?-B-o??--??B-----o-B---M---o?---BB-oMBo-?BEEoBoB?EBo--oB----M-?-?-oB-M-E?oEoM-?o--EE--?-oo
--MB-o-?B-Mo?-MBMBo-?-o-o-ooMo--Mo-E---o?o--M-M-MoB?-BMo---M--Mo---oBo-E-E-?--?M-BBMEoB-B-----M-?-?EBMoB--?-Mo-o-oo?MoM--o-o?E-Mo???MM--oM---?-o----o-??B-o-??-?o-BoE?BooM-?-?MB-EoMM--M-BM?-M?--B-MM-oo
-?--?-BM-Bo-B----??-oM??-o-B-BM---o--M?BEo?-M---Mo??ME--oM-oB-?oB?-?-Bo-o-M-oBo?MB-oM--?BMM??-o-oM?--?M--o?--?-o-M--B-oB?BB-MB??MBE-MM?o--?--B-B-oM?o-oM-oMEBB-B-Bo-Mo-B?-?-?-B-MM-E-----M--B?---o-B-voo
o-Mo--E--MMEo-oB--o?-?-?-?EB?-o-?--Eo---BMo?EE?-MME-oM-??-E?-?-??M-?-??--BBo?--E???B---oooB-Bo--Bo-?-?--?Eo?ooo--BB-o?M-----B---o?B----B-M-B---?EMoo-?---M-?o-?-o-?BB??-?----MoMooM?-MoB-??--?---E-BBfoo
?-?M-M-EoB-M---?Bo-B--B?o-?MBo--E-M?M-E?E---?-o-M-BoooEM---o-MBBo?E---M?--o?-o-M---B-?B?E?-o?M?-?--???B--??---MB-?M-M---oEBEoME-BooB--o--BM-BMBo-?---oMo?B--M?-oE-o---EB--B--??Mo-o-EBBBoMB-Eo-B-M-Mofoo
-E-----M-?B--M-Bo?-?BM--o-M?M?M-?oMMM--?M---E-oB-B-?B?Bo?-B-??---EB--o-MBoBo-?o?M-B--M-oBM-?-??--o-o--------oM?--M----B?B?MME?-o-oMo?Moo-Eoo-BM-??oB?B-B?o--?oo??-M-o?----?-o-M??-o--M?--B-o??-M?-M-Efoo
o??Eo-oM--??M?-----BoM---M--?BooBoBBM--ooMB?-M-oM?Mo-oMEo--E-E?----?-o---?-o-oM?oEo--??o?-oMMEoBoEB?M-B?o--Bo-B--oE?M--E?o--Bo---MBB-?-B?-oMB-----o-?-o-o-MoM--Boo--?M?---B-oo---o?E-oE-o?Mo-MooE-MEBfoo
oMo--M-MMEo-?oE----?Moo--B-ME-ooo--?-E?EEoo--?--Eo-oMM??-oMB???-E?----?Bo-MMoMM-?B?M--B-B--B?ME-Mo?--oM-M------BEo-o--BB--M-?-Eo?--M??-?EEB?E-o-EM-BBE?M?--BooEoE-oo--E?ooE-??o----M-MBM?-o--oM-?-o-ofoo
Mo-o--o?-M--?M-oo--Mo?o--?--?-?--?oo-??-MoEo-o?-?-o--Mo-MoMB-?----?o-Eo-B?-M--?-BMMB-MBEBM-EoMMB?--oo?-E---?M----?--oMB--?oo-o---ooB---EM----MM?MoBB-B--o?EBE-?-?o-E--o--E?E-B?EEE?-?oE----Eo-?--MoM-foo
m----------------------------------------------------------------------------------------------------------------------------------------------------------------------------------------------------foo
X----------------------------------------------------------------------------------------------------------------------------------------------------------------------------------------------------fXX
