-M--M-M--?---ME?-BBBMo-?-M-?Mo?BE?-M-----o-oM-?M--B---MB?-B?M-M-o?o--Mo?----?M-o-M--o-MM--o--?B-o-E-M-?--oEB---MB--B--B-?E-ME---?-MoM---M?---?--M----?-o-----??-M?-------?EB--oE---BBooMMBM?-o?----M--oo
o-?-?-oMoB??-?-Bo-BBMB--??o----B-B---o-?-Boo-B---o---o---E-Mo---o--BB-B-BMME-oME--BB--E-?-??-B?oM-?---?--MM--?--E--oB---M?---o-?--B--?oE---B--M-?-?-M--oo---EB-M----?Bo--E-E?-E--Mo-M-BMoM--oB-M------oo
B---oB---B?--oE-ME-BBE----E-M-?MoM------M--o--EEMo----------MB-------?MM?--B-B-?Mo-E---MoBoo-E-?--B-oo--oE--MM-oM--EBo-MM--B---M--?M---M----o----?M--??-M--E?--E--oM-E?-BB-B---oME-M-M?---oo-E-o--E-B-oo
-B---?--MME?--B------Mo?-MBBM-o---EoEM--oEBM-BM-MEE-?--MoEB--M--M----B----oooM-?o--BBM--M-B--M-o-EM--?--oM-o-E?-?-oM?oB?o--E-E?-oo?---o--BM-B--??---BBMB--?---oMo-E-E?E-M---oMEMBB-M---MME---BB--BM-o-oo
-M----------o?-?-M?--EMoBBoMB-o--E----oo-M-----MoM-MMB?-oB---o--?-o--------B---B---MMo-M-?--?M--o?-oE-M?o-B?B--o-E---Mo?-B--EB-E?oE----EEB--BEME---o-E-?--o----?E--o---o---EoM----?o-E-M----oo?o?Bo?o-oo
--M?Mo---MM---B-EM?o---MoB--ooB?M-?B-B--E-o?B-ME-----E-B-oo---B-?-------?B?-M---ooBB?--BMM------M?-o?-?--MM??E?-MBM-E-MB----?--?oE---EoB-o--oBo-?E-MBB--?-M???--Mo?B?M---Mo----?-B-?o---??BMMo------M-oo
--B?-M-??-------M--?B---BoM--EBo----EM-EB-M----Mo-BM-M-M-BMM-oBo-o---BMo--M--BM--oMM-E---B----M--B--EEM-MB?MM?o-Bo??-o--B?-?E?B?-B---?---o??---MMB-o-?E-?Mo??--oME?MoB-MB-oo-B-?E-?---B-ME?-EB---o-B--oo
B-M?-?---o-B------MM-B-?---?---Bo--E?B-MMB-oEBE-?EM--?-M-M-----E-?BB-?B?-?--EB-M---B-?M-?--B--EE?o?o?--------oBMM-------?-----??M--M-B--BB-M-EE-?--?o-Bo-?M-B--o-M-oEBo-?o--M??-?MM-?-oE?-?M??-E?Bo--voo
M--Mo-E--o-M?EoM??o?----BB---B-M---MM----oBE-----MBE--MMB--E?-E---M-BBB--MoB--BB--B?BBM-E--B--M?-?---Boo---?-oo-EB-???M?o-EM-EB--------?-M-?o-?-o--BME--E-?-BoE----MM---EM-B---EE?B?E--MEoE----MoMB--foo
Mo-o----E?M?oBEo-B-oM-M----BM?--o-M?-?M-oEM-?--B?-?-M-Eo----EMB--oE?--oMB-E-?-B---?B-??EB?Bo?B-M--E?-E??-B-Bo-?EBMo--EEEo??-o--o--ME-?M-EB-?E-BBoB?MB?-MB-?-MB?--?B-?B?o-?--M-----BoBEo-MoB?--B-M---ofoo
----o-MM-----o--EMBo-?--?-?E-oo-MB----M?-?--oM-M-o--BM---M-??-?B---o-M-M--BM-B----M--oM---B-o-B-M-?MM?oo-M?MoB-B--B-B?MMEE--oBM--ME??E?M?-MoBE-?--M-------B--o--ooM-?ME--B---MMB-B---B-BM-EBM--MB-?-Bfoo
------?--B----B-BM-??-o--E-?o---M?o?---B---M?-ME-BB-EB---E?-Bo--?-o-?o---M-M-oM?E?--MEoB-oEMoo???-M-BME--E-B-?-E--?-B--B?B-o---?-B---BM-o----BM?-o??-M-M--?---M-----?-M-MMoM---M-oB---EE?-MM-oM-B-M-?foo
oo-EEBT--o?--Eo-?Bo--B-M------EoB?EoM?M-E--?-M--o-o---???Mooo?M?-----ME-E-B----??oo?B-BM-EM?Eo?-?---MBM-oBo--??--o-BM-??-?EEM?----?-o--------o?-MB---------?BM--?MM--MB--MM--MB?o----o-B---M--o-B?B--foo
-MTTBT|-oT--E-oE?MEoEE?B?E-BB-B?-o?-?-B?-T?-BBB-MT?-ET?oE---M-M?-EMM-TM-M-E-BoT-o-M-?-TMoMTT-M?o-T-T-BoBToE?--B-E-Bo--M-?-B?-----?E--To-ooo-oB-o-?-T-o-?E-oEBM-----B?--Eoo-TBBo?-EB-oMEM?-M-----E??-Bfoo
mE||B||?-|-E?BMMEMM--?oB--o--ooM-M-o-o-EM|--EoE-?|Mo?|M-B?B??MB-B-o??|-Bo?-o-o|E?oBB-B|-EE||EoM-E|E|?-E-|--oE?----MB-MM-oo-EMMEo-B--o|EoMoMBBo?B---|-M-E-EBBMo------Moo-M?E|-MoBM-oo?o--B-MMoooo--BEBfoo
XXXXXXXXXXXXXXXXXXXXXXXXXXXXXXXXXXXXXXXXXXXXXXXXXXXXXXXXXXXXXXXXXXXXXXXXXXXXXXXXXXXXXXXXXXXXXXXXXXXXXXXXXXXXXXXXXXXXXXXXXXXXXXXXXXXXXXXXXXXXXXXXXXXXXXXXXXXXXXXXXXXXXXXXXXXXXXXXXXXXXXXXXXXXXXXXXXXXXfXX
