M?--E-o-----EB-?-?-o-----EE----E?-B-----?Bo?M--E-??--o---oB--M?--?-BBBB-o-E?E-B?--E---B?B--oo-----E?-M-B?BB----MM-o-B--oM-MoooM?-MBEME--BoM?--oo-----o--EoB?B---?-E-----B-E-?---?B-?-?E?--Eo-o-BoEo---oo
B-M??-BBBE-o?o-?M?-?BEB?-MMBM--B-EB--M?-?M?---?M??-E-B?----o------M-oM-MBM?-B--o--B---B-B-EE--Mo-o?----M--MBo--E----E--M-o--E-o-B--?-??--M-----?-B-E--M?B-MB-o--M-ME-o?--?--M--oBEE--MBoEMM?---oBM-?--oo
BB------EME--MoE---?---M-?M--EBB-----B----?MM--BMB-BB?-Moo-?Mo--?M---oo-B--?B-BBoo--?----E---??-??----?M-EM----B-----E-B-E--M-E-E-oBEM--M---B?-oM-MBE-BB--E--E?o-o---E--B--B-B---MMo--B--B---EM-E-M-M-oo
?Mo-oM-M-----?-?-oB-----M-E-o??-o-BM-ooE-----B--MEoE-BB-MooM-EMo--M-o--oB?M---?B--oB-B-E-?-oMB-----o--M?-?--B-?-E---E-M--M-?ooB-?--M?-E-?-E-?-EMo-oEB-??-MMB-M----E-B-o?-EMB-B--oB?---M-EooM--BB-M--o-oo
M---Mo?-M-?o??-oM-EoM?M-o-M--MoM?oEM--------MooB---BE---M--?--M-M-Bo?-?o-B-o-B---Eo-o?-??--B--B--------B--E--?-?M-o??-?-oEE-----EE-E---o--B-B-M-EB?-B-o---M???--oB-oooo-o-M--?-oME--B---?--M-B----B??-oo
o-BB--o-Bo-?oEM-o?B-M--o---E-o-Bo--M??Mo--E--?E---oBB-M-o-B-BoB-B?--M-MMM-o--?-E-B--??BM-?--B--Mo---ooB---B-?ME--B-BM??-BMMo-o-M-?-B-M---?E-B-B-M-BE?-------M-EEMMo?--B-??o?E--B-M?---BBo??--M--Bo-?--oo
o-oMoo----M-o---Mo----ooBB-----o-B---Eo-o--?-??-------Moo--B??-?B---oMMBM?M----M-MB-o?M-M-------E??MM-?M?-MB?-M-E-o-BB----oEoE--?-E-?-o--M---M--o--M--?Eo-MM--?--?M-------?-------M-B-o-o-?M-??--oM-M-oo
---BB--o-----oB-BoMB-B--?-M----EBB--o-E-?oEoo-?---EE?MBoE--?-------E-B-M---E-B-o---E---?o-B---E---oMB---------o----o--E?E-o-?MoB-B?M-?BBo-?BM-ME?M-o---MB-o--?-B?B--?-oM?-o-?MoB--oE?--oEE-oMM-o-M?EMvoo
oM-o-o------Mo--MB-?-o-M---?--E--oM---?BBo-B----o-BM----?o--Bo?-oo-??-B----Bo---o--B--E-B-oo--MM?-B?--?o-?-E----?-?o-?--?E?B?E--MoMoo?---M-BM--B?ME--B---MM--E-o?-BE---E-M-MMMB-B-B?--B-BB-?MMoM-?-?-foo
-M?o--M-----B-o-E--?B---o-------?o-EEo???-----M?--Mo?M---B-E---B?M?BM-?MoE-E?M-o-o-----oE-BM?-MB?B--o-------M--EoE-oE--oBBM--BBo?---oo--B--B-ME--???-B?E-B--M?-oB-oMM---o--??oBBM--?-o-------B---o-B-foo
-M---B?B--oo?B--??M---?--BE-E---oB----o??B-M-oM-B--B?o--B-oM-----B-----E-MM?o---?-oo----?o-B?M-EB-Bo?oo----BoM--M-B-MM-E-B??--EEo--B---B---B-o?--E-?o--?MMooE--BoBM--oo-Mo-BM--?--o-M--o--M--E---?-E-foo
----o--M---?---???----o-??-?-o--BM--M--?----Mo--B----E?---?--?MM-o-MB--Mo---MMME-M-?M----?o-E?--E-M?MBoM--oMB-o--E-B---?MBE-------?--?oM--o---B-BB?BM--BB---B-M?o-BE-o---M??M---?--o-EoBMM-o-M--EBMMBfoo
oMB-oEME--E-E?MMBM--?-M---Mo--oo--MM--oM----Moo?----?ME?---M-B--MBMoo--M-B----o---B-EB-----?-M--MEMB-E?-B-o-?-Eo-?--M--E-----BMoE?E--EMo-oBBB---BB-BB--?-?M---MB-B-BB-?M-o?BToM?M----MB-o--?MMoB-E-E-foo
-----?o--?---TBEM-?oMB-o--B-BM?MEM-oMMB?---o---TMo?--MM---Bo---o-T-E-??-?o----oM--?o?EBo-M--oMBM?-?--?ME?-o---??M-EEBoB?--M-B--E--B-T?-?E-MMT-E-B-o--T-T--Eo---oo-?TT--MM--M|---oT---o-BT?M--BTT-M-M?foo
m-BM-MM?E--o-|M--MMMMo?MBBM---?oBoB-Bo----?o--E|B?---o-o-?-E?M-??|----oM-o--o?M?oE?-oM-EE-?o-oEEo?M--?B---M---?o-BBM-?M-o---B--BBM-M|o--M?--|EM-oo?BM|-|?E-?E-EE-o-||E--BBoB|-o?-|--EMME|-E-E-||?M-B-foo
XXXXXXXXXXXXXXXXXXXXXXXXXXXXXXXXXXXXXXXXXXXXXXXXXXXXXXXXXXXXXXXXXXXXXXXXXXXXXXXXXXXXXXXXXXXXXXXXXXXXXXXXXXXXXXXXXXXXXXXXXXXXXXXXXXXXXXXXXXXXXXXXXXXXXXXXXXXXXXXXXXXXXXXXXXXXXXXXXXXXXXXXXXXXXXXXXXXXXfXX
