?BoMB?-?M-Eo-M-oBoo-?BEM---MB?oM--E---o-E-BMoE-?-BB--oB--?-B-MB--?--M-o-Bo?MM-oEB-MM--o-?B?--B--E-E-?EBB-MoME--Mo--EM-o-o??E--B--?-M-BMBoo--B??BB----?Mo?M?-BMo?---M---?----o-?----oMMBM-o-BB---o-oM?-oo
M??oMBB-B-M--E-?EB-EE----oo--M-BB-Mo--EBB--?-----?--?o-------?-B-B-M-Eo---Mo-o?-MMBM-----EB----?-M---B-oo-EoMo---o---M---?-?--EEMEE--EEBM--M--o-?-Eoo-?---M--??-M-oBB-MM-o-BoMM-B??B---EE?--MoBMoMo---oo
-oMo?--?----E?EBB-BBB---E---??-MBB-B-M?---EE-B-o--oB??o-?-oMM----M---?MB--M------?-oMo-E-?B-?Bo-o---M--MB-Mo---?Mo-BoB---B--oBM?M-Mo-?-o?E-BoM-?--?-oMMoB---M?-o--BBoBoo-?o--Bo?----M----o--E----BMM--oo
----?oB--B?o?--MoB-B-M---M--M-M--o---MEE-oB-E--M-?MEBEo-M---M?o-?-?B-o--B--ME-?-o------?o--E-EE-B--M---E-E--o-oEB-E?MBBoM?o-?M-??E---ME--M-MM?--B-o---M?-----M--??--M-?--?--E--M-BMMoB-oM?-EM-B--B?-M-oo
-o-?oM-B-BB-M---ME---M---B--M-?--oBB-B-MB--?B--B--MB?B?E?E--B-?-B-B-B---BME-Bo--Mo--B-B---MBMMBMB--B?BMMo---MMM-?-B-?M-???B--?----?-E-M?-M-B?E--E-M---?M?o?-----E-E-Eo?o?-?-?------BBo-oB----o-B-Eo?--oo
E?o-?M--BoME--?oo?B--M--oBBM---BM--?B--M-M-MoE----M-EoB-BB-oE--M----B--??MBoo-oE-M-?BBoM--???o-B-MEBoME-ME--o---E-ME-----E--o----B-?---?B-EM-MBBM--M-?----o--M-?BE?-BBoo?M-?o---M--BE---oB-oM-MB--?B--oo
MBE-M--o-o-M?--o--B--?--BBoo---M-M----?M----oM-------o--M--?-oE--o?MB-Mo-M-M---?-M?--E--ME?-?-?---?B-BB-M--B-M?--M-??B-E-?-----BMEB-B-M--?---?--Bo-----E?M-B-oE?M?oB--B-MBoB-B---o--B?-MBEMoMMoMMoM-M-oo
--M-EBoB--?BB-M----M--o-----?--?---oMBoM?o-BMo--------M---o-E--oB-?-Booo-M--?o?B-BM-------E?MoE---MB-?oooB-M------?B?-E-B?EM-o--BMB----MEB---?M---?--EB?----?--o?---BBoo-M?MME?----M??-M-ME--o-oB-BoBvoo
-o-BM--E-M--BMMoEoB?-ooo-?E-------MM-?---?-?BM---?o?M-?--B-B?BB??-?--EoE-----?B?---Eo-M--?-oBE--EBE----?MB?----MoE--?oBM---M-B?o?-BB-----oE-??Bo--M?-B-M-?o--M-MMo?-MM--?-------E--o-B------EE-?---MEfoo
B-MB?--B-o-M-???--Mo--?o-MBoMBM--EE--M--ooBBoM-B-------?-EM-??BMM-B--MMB-o---??-B--M-E???Mo--?o--M----oE-o-oE-?-----?-o?-Bo-oB-M-B----o-BB?o---E--EB-?--MBBE---?-E-?-M-o-B?MBB-B---M-?---B?M?B-E--EM-foo
---?MB----Bo-?----E-BMM--MM?o-B--MM-Bo?M-B--??-Bo--ooE---B-M---B-E---M--E-MoMM-?oM-oM-o?E----?--M-?-B???Eo----?o--B?---Eoo?-?-o-E-BB--oMME-?-?---EM-E?E-M--M-B--M?B-M-M--B---o---o-MMo--BM?--B?M-?--ofoo
B-B------o?-M--------E-BE----o-oo-?o-oo--------B-BM---EMoBMMBE----B-M--E---?o--B-o------MBo?----?E-?-E-E---?---------o-?MMM--BoEB-o-B---oM?E----?BoE-BBBo-oM-----?---M-o-?o-B-E-Bo--?BBM?----o--E--Mofoo
oB??B?-M--oE-BoM?E--EMoEBo----E?BoEBMBM---MMM--oB----oM?-E?---BME-?Mo-oB-B--E-o-M?-?-B-oB---oB-M--MMEBoMoo-?-ETB--o--??o-o-?M--B--T-o---Too-E--B-?-M-B?-E??EE---MMo?MME?E--M?B---o?B?B---B--o---BB--Mfoo
o-o---o--B?B?--?B--oMM-M-B?MT-M--B?---T--?E---E---o?o-TBE-B-E-oT--?--B-B-M-E-B?---EM-BBToB--E-oo-T-TMB?BT-TBM-|-E?-----T--EoE----M|BB-BM|-E--T?T---TM----TE-MT-BMM---oM-T--B-?--M--BB-?EoTo-o---?-TB-foo
m-M--M-BoM-BE?-BM--MB-E?-o?B|B-EMBBBoE|EoBM-EoBM-BM?o-|-??E---E|B?M?o-Eo-oBM-B--oBM---M|-----ME?E|M|EoE?|E|MMB|----EEM-|----?--ooE|-B?BE|-BoB|B|M--|-M-MB|?BM|?oBoE--MMB|-B--EE--BoM?EB??|E--EoBo-|-Mfoo
XXXXXXXXXXXXXXXXXXXXXXXXXXXXXXXXXXXXXXXXXXXXXXXXXXXXXXXXXXXXXXXXXXXXXXXXXXXXXXXXXXXXXXXXXXXXXXXXXXXXXXXXXXXXXXXXXXXXXXXXXXXXXXXXXXXXXXXXXXXXXXXXXXXXXXXXXXXXXXXXXXXXXXXXXXXXXXXXXXXXXXXXXXXXXXXXXXXXXfXX
