--?o---o--o---?o?o-??--o-?--?--o---?--??--oo?---o---o-?----o??---?--?---o--o-o???---??-?--------o--?--?----o-?--o??--?---o?--o---??-oMooE?oBBM-oBoBo-Bo-o----o?-------oo-o---?o--?-?-oE?Bo-EM-?--oo?o-oo
--o?--?o---oo----??------oo-?-?-o---?o--o---?-??--o-----???-o-?-?--o------o--o?---?------------o--oo------------o-oo?o-------??o-?-?-----o??Eo-oMo?E--M-oE-??oo---oo?---?--ooo?o-o--?oB-B?-?o--M-MoMM-oo
---o--???-o-oo-?o?ooo-o-o?-?o--?-o--------o--o?o-o-o-o?-----o--o--oo--?ooo---o--oo-?-o-?--o?--o----?-----?o????--?-o-?o----------?--?Bo?oo??Bo--EB--E-EB?---o?--?--o???---o-?o------?E?oEB---ooMBM--?-oo
----o-o-o?--?--?---??--o--o--------?o---o--o?-?------?-?o--?oo----?--o-o-?o-?o?--o?--o-?----o??-o???----oo---?------o----?-o?o--o--?--oEo-BE-EEE?--??o-o??-------?-o?o-o--o?-o--ooo--?Moo--?o-MoMEEM--oo
--?----?------?---o----ooo--????o--??-o----o-----???-?-o-----oo-o----o-o-?--o--o-o--oo---??--??------?o------?--??----o---?o---o?----EoB?oMBoM?MEMo?o?oo-oooo---o--o-?oo-?-???--??-oEooE-??-o-EM?-o?o-oo
-----o---??-o-?----?--?---o?-?-o-???------o--?-?--o-----?---??-?-?----?-?o??-----oo---o---o--?o-o----?-----o?o--?---oo--?-o-o----o--o??BoM---M?-M?--Eo??-????-o--?--?o?o----o???-o--?-EM?o?--?B--M??o-oo
-?o-oo-??--o?--?--o??--o-?--?--o?--o?--?-?--?------?--?o-?---ooo-?----o?o---?o--o?o-o??o--?---o?--o?oo--o--------------?---oo-o?-o-oB-B--?ooo?Moo?M?BMo-?E?-o--o---o-o???o-o------?-?o??E-MM?-EEoEEoM-oo
----?o---o-?--oooo--?o---??o-----------o--o---o--?-?o???o?--o-----?-oo?o-o---?o----?o-------o-o--?-oo?---oo--o??---o----?o--?o-oo???o?-E?MoB-?-?o?-ooM--M?---o-----o----?-----ooo---oEEo-B--M-B-o??o?voo
-?-?---o-o--oooo??---??---?o--?o----?o---?-o?o--o-oo--?o--o-----o------o--?--o--?o-??---?-??-o?o-??--?--o?-?-oo-o-??-oo?-o-oo--oo-o??Bo?oEBB-o-BooB?-o--ME?------o?--o-??---?oo-?ooo-??-?Mo-EoM--o?Mofoo
-ooo-?--o?--o??-----?-?o??-----o--?--o----------o--o---?ooo---?o-----?-o-?ooo??-??--?----o??oo??-o?----o-?-?-o-o--o-o?--oo?ooo--?-???B-oEoB--?-BMB---?B-?B--o--o--oo---??-?-?-o?-?BoB?-o-E??Bo?MMo-BBfoo
-?--o-oo-?o?--?--------oo-o??--?----o--o---oo?---?-o--??oo?---oo---------o-?--??o-o--?-?-?-??--?--o--??--o-o--o------?--?-??------?-E?BMB-M?B--?-B???-o?Mooo-o---o?-o---o?-o----oMM?-MBo-??M--B?-?oB-foo
---?-oo-------??-??-?-o-oo?ooo-oo-?--oo-?--?o?------?-??o?o-?---oo---o?-----?--o-ooo-o??-o-??--o---oo-?--oo-?-?--?----?-oo-?oo---?---o?B-E-o-B?o-o-o?MEo-B?-?-?-o-o----?-?---o-?-oM?-MB-BEBBMB-?--B?-foo
---o--?o-o?o-??-o-o?o-?-------?---o??------o?oo-?o??---??-?o?----?----o---?-----?-o-----?o---??---o-??-oooo-?----o-o----?o------o-?oB?BME-BE?--BM??-T?B?o-----oo-????-?o?o-?o-oo-?B-o-B?MB--oooEMB?oofoo
---?-??ooo-----o--?----------o?-?o---?o?-?----o-oo-o-?--?---oo------oo-o---oo-?--o?o?o---o---o----?-o--?--oo-?-oooo-o-?--o-o?-??-?-oEB?-ooBM-EBo-o-o|-B-BB--o-ooo-?-??---------??o?o-E-B--o-E-TM?M?-?foo
m?-o---------o-o-?-ooo??o--o-?o?-o-----o--?-?-?-??o---?--o-?o----oo?--oo?------??--?o-o???---?---???o-o--o?o-o---o-o?o?o-oo--oo--?-o?MEBo-----?oBEoE|-?-E?-?o-?----???---o--??---?B?oBME-B??-B|oMoB?-foo
XXXXXXXXXXXXXX---XXXXXXXXXXXXXXXXXXXXXXXXXXXXXXXXXXXXXXXXXXXXXXXXXXXXXXXXXXXXX-XXXXXXXXXXXXXXXXXXXXXXXXXXXXXXXXXXXXXXXXXXXXXXXXXXXXXXXXXX---XXXXXXXXXXXXXXXXXXXXXXXXXXXXXXXXXXXXXXXXXXXXXXXXXXXXXXXXXfXX
