?--B-EM-B-----B-EB---o--M?---?--o?E-o--oM--M-M--B-o-E--oEMo-----Bo--E-BM?-o-o-EM-?-?--Moo-oB--o?-oB--M-BoM?---M?----?---?MM--?-M--M--M---B-?-?-M-E-?BoM---o-M--o--M?-Booo-BBE--o-o------MM---?--?--MB-oo
---o-B?--oB------o--M---M-B-o-?o-B?-E-?-B-M-o-oM?-MMM---Bo----?---Mo---M-B---E???o-------B?---M--M-B----B?MB---?--o?Eo-o--?-o----B-B-M--M-----B-----BB--E?-?oE---EoE----o--M-BE-M----?-oB?B---M?ooo---oo
----B-M?-oB-o--MME-oM-M-B--B--o-oMM-Bo--M--M--oo---o-o--B---?-M-?-EoEo-B--EoEM?-?-ME--?-BoB?--M-o--oM-----B--B-oB-?-B-B?E-M---o--Eo-?-o---E?-----B-----?MoM-o?--BM-M-?-?B-o---BM?ME??---Eo---E-?--o?--oo
--o-?-E-oE-E?-M--BM--o??B----MM----EBM-BM--o-BBEo-BEo----------EE-BBBo----BE?-oo-M---o-----M?-------MMMMBo-ME?----B-?-oM---o?----ME--EB-??MBooEMB-?---?MM?BoB?o---oM-?-?o-B---M----BEM--Bo--B?B----o--oo
MBB-?-B-MMMB?B-B--MB-B---?oB-B----??---??--oo-E---MMo--BM----M-M?--EMEM?o?-M-Bo---?B-oo----o--M-M-----E-BB-M-o---M-?o--??-?--o-o-B-MoM?---Moo?--B--?oEBB----B-M---oMMB-?--M???--?E---oo--??--M-oB--?--oo
EoB-?-o-B?Bo-?MM--B---B--MB??-?oE-B-Eo-B-?-M-E-B--E?---M?o-M---E----oMoBMM?MM--MB----?-----oo----EBB----E?M---B--o-?EB-o?--?o???B-Mo--o?--?-ME?oEo-MB--?o--EBE-E-?--B?-Mo-Eo-M-EB--?B-B-?M--M-?---E?E-oo
?EMo??---MMM-----?BoBo?M--Bo--oBM?EoM-?o-B---M-o--B-E--?M---oMMB------M-o?----?E--o-MoEEM-MMM--BE--M------EB--?---B?----M-M--B--MM-?--Mo--oo-BE-B?--MB?-EB---M-B?M-B??o-Bo-E---B-M-M---BEo-E---?o-M-B-oo
?-?----B---?Eo-?Mo-o----ooB-M-E--B?-B??-B---Mo-Mo-???-BMM-MMB-?---?o-?----o--MB-B----M-----B---?MM-o?-B-?M?---o------B?-----?-o----B-o-M?oE------M-o--B-?Eo??E---M--B--?MM-M-?M-M--o-B?-M--B-?----EoBvoo
M----EB--B-MBMB-?BoBB--?M-o-?-M----oo---?oE-M-------EB--MMM--oE?---o-??--M---M--M--o---BM-----oE---E--o---oo?M?oM-BEEo----BB-?-E-?Eo-B----Mo?--B?-Mo----M-M--BB-B-ooB---??EM-E----M--?o--Bo----?-?---foo
--B?-M-?M?o-E----?Mo--EB--??MM?-o-E?-o-------??-o-o-?M--?-B---B-o-BB????o--ooB-M?---o-o-?oEB---M-o-??---?---M-B----M-B-MoB?-??o-o-M-o--------M-E-??EMoB?-----?-B---M---?BM--M--MMo-----ME----oM--M-?-foo
B------?M--M?---B-E-o-?-?-?---ME--ME?oM??Eo-o--?--o-?-o-o?---B--?M-B-MM-M--B--B--?E----B-?BMooM---Bo?o-?--?-EB--Mo----o---M----Bo--MoB--BE-?B-?------M-MMBM-oE?-M-----BM-MB-BB--M-?o--??--oM-B?----oBfoo
--?-o-oo-----o--BoBoM-------E--??-MM--E?-M-MoB?MEo--?--o-B-?M--?-oo-M--B----oo---?---o-o--EEo-?-E?--oB-?oM-----BEo---EB---?--E---MMMB?-MMM-M-M-ooEB-oBo-M--o-M-o-??--o--ooB---??M-M??-E-?o---MMBoM?-ofoo
EE--??T-o--?-o---??E-?-o?--oB--?----o-?EMo--E-B-MBT-MT?--------?Bo?--o-----o---B------E-B?TBMooB-o-E---??o----o?--o--B?o---MB-M-B---o-M-M-BM-o-M-??--B--?-B?B-----Bo?MBoE--M--oB?-?-M-Bo--M?--?--BM--foo
?B-BT?|oT----oo?M-o--MB?-B---T-BEB----BM-o-o-BB--?|--|T--T?B--BB?---?T---?-B?-M?---M--T-TB|M-M--E?B--?TBEMTT-BB-----T---Mo-BBBM---Mo---?----EE-o-EM-M-BT----BM-M--Mo---oTo--??ToM-oMBoE--oo-MTT---B?Bfoo
m-o?|B|E|--EE--?---E-M---ME--|-BBoo-M--o----o-B-M-|?-||EM|--EE?---?Bo|-M?E-??MEEEoM--M|o|?|Eo--M-MoM-o|-M-||--oB-ooE|-oMoB-BB-M-o-?-oo-o--o-MB?B--M?---|-BoM-o--Eo-B?BEo|EM??-|B-M-M-M?-E-o-o||MM-MB-foo
XXXXXXXXXXXXXXXXXXXXXXXXXXXXXXXXXXXXXXXXXXXXXXXXXXXXXXXXXXXXXXXXXXXXXXXXXXXXXXXXXXXXXXXXXXXXXXXXXXXXXXXXXXXXXXXXXXXXXXXXXXXXXXXXXXXXXXXXXXXXXXXXXXXXXXXXXXXXXXXXXXXXXXXXXXXXXXXXXXXXXXXXXXXXXXXXXXXXXfXX
