B??-B-M-BEMB-M?-oo-o-BB----B-oB?-M--?----oBB-??B--M-?M--M-M-o-?-M----oo-M?E---E--BM----oM-Eo---o-Mo?---BMB?B---oBM?--?---o-?-E-----?oB----o-o?M-??MB?--B-?-?o-Bo----B---Bo-oMo-?---M-o--o-------E-B---oo
??oMMBB-?M--Eo?-?B--?----Bo-M----B-M?E--o---EM--M-B--?Bo----Bo--M?oMMMB-------?EE---?BM-?-----B--B--B---E?MEB--BB-?B----oE-B---MB----?-??--E-?BMEB-BM-M-o--M---oM-----M?-MoE------?-M?o---EB-oEBM-E-o-oo
--o-o-?EM-BMM--EM??----EM---?MM---B-oB--B--M-M?B-M--Mo---EMM--oMo-o-----BMM-BB??---o-?E-??Eo-E---BBB----Bo---E?-oooB-------?-??E-EoMB--BM-BM?E-BBM---?B-o--M-M--B--B?-o-o-------?-E-Bo--oM--MBMo--?---oo
o---?---oBoM-?---?MM---?MM-B----?-MM--o-B---o---?B-EE-BM--BMEBo-M-M--B-o------M---E-o?MB-BMBBB-??o---?-o-B---MoE--MBo--B?--E-BBM-B??BBB--E--M-o---------M--EBM--?oo--??M---?ooB--oMB-M?M---EBoEME--B?-oo
EE---Eo-Eo-o?E--------?oE?B-??o---BEMB--M--MB-EM-Mo---M---o--Bo--oBBE-M-M---B?E-o?-?--M---?B-B-?E-B-MB---?----M--?-M-BBoM?E?-ooo--MB--M-M-oM??-?Mo-?-MM--BoMoB-MM-o-?-o--E-ME-BBMoE-E---Moo?-M--?BBE--oo
?Moo-?EM-M-??B-MB?ME---BBMMM-M--B--BM---?--M--M-B-o-----M-BB-?--MoM-------?o?oB?B---B-MB-?-?-E--?B--o-o--oEB-oB---o---oE-MB?Bo-o-B-o--EMo-----oo--BoooBB----M-?M-?B-E-?-E?B--M?o-BB-M-----M--B?----?M-oo
-M--?MM??--oo?oM---?M-----B-oE---o------o----MM-oB----B?M-BB---?-Mo-BE?-EoMBMM-B-E-o--?oBo-EE?EM---M-M?B-?B--B-E--BM-?--?BoM--M-?M-B---?--B--oB--oE--MB-o-----MMM---?-o-----o--???MMoE----ooo?Moo-M---oo
-E-BE--o?-?----MEE-M-BE?EM-??MB-E---o--o?-EMB--?---o?----E-B---EM?-?o--B?--?B--o--oMEB?M--o?B----MBB?-----M-Mo-?-----BoooMM--oE--M-?M--M-o?--EMo--?M--M-??MoBEEB-oEE?-?--E-M-oBoo-B--M--?o---o--M-?--voo
-?-M-???B--MMB?o-M-E--BM--B--B-EMo---B?---M---M--Bo?B--?-Mo-M--B-B?oBM--E?-B--B-oBMMM-M--?oM--?B?oM-?-oM--o-Bo---BB-o?o-?--o-----oo--o---EE-BM?---M?-E?E-?--M??M-EM?--oB-?oM?o--o-B-o----MM-------o--foo
-?--o-MBBE------MM-?-M-------MoM-Mo-EM-BM-?-M--?---?--o?--E------B---Bo?MM-B-M-oo-o-M--M--M--o-oB---M-E-?EMM-ME-ooM--B-------B-o?----MMBM??--M-B--??BB-Mo-M-M?-BoB?-?-M-oME----?ooM?M?M---ooEE?--oE--foo
-ooo-??--?----??oM--B--M?-EE?---o--oBM-oo-Bo-o-----B--oE?MB?--E--oB-B----B--E-?--Bo-M-E?-o-?M--MB-----M-----o---o--BEB-oM-o--E?-MB?--?-o-EBEo---?-B--Mo----ooME-B-M-M--E-?M----M--EB------E-BM-MM-?oEfoo
---o?E--oEo--M-B-B---E?-MM-M--B---o-----M-MoE----?----M-BE??o-?B---?M-o---M-B?M-B?o-----o-M-M--??-B--oBEoME-----?-E--?BE----o--o??-B---oE--M--?BBE?o-?----B--M----E-EM-?-BooM---EB-?-o--M-?M-BE-oo--Bfoo
oTEBE--o-MB--B?M--B??--B-TB---Booo--o---o-o?--B--?-M-o-o-?-B--?BBB-----M-EoM--?-MoE??BMo-?EEMoo-M---?Mo----BBM-TE-?--M-??oE----?---??Eo-TB--?--?BM-oEBE--B-EE--M---BM-B--BBB-?--BBo---B--E-ME-MM-?---foo
-|---oEB---T?-B?M----o---|-M?-?M?oM---Mo--T-EE---?E?--E?TBoM--EBo-To---?--?-o-o-M-T-T?oo?-TM-o---B--o-T--T---TE|---BB-ET--?E-??--B?-M?T-|-??M?M-MTo-----EB?BB-o-oo?T--TT---ET?-T---?-MB-oMMMM--TB-TEEfoo
m|-M-B-EEM-|-B-o??-E?-?--|o-BoE-BBM----?MM|o??o-?---o-?E|E-?o?MEMo|?B-?-?-Bo--M?Bo|-|o---?|-Bo-?--BoEE|?E|MBE|-|EB----?|o-o-?MoM-E-oMo|o|??E--oMM|--EEM-B?E-?Moo---|B-||-M-M|B-|-oM-B?Boo-o-EBM|-o|--foo
XXXXXXXXXXXXXXXXXXXXXXXXXXXXXXXXXXXXXXXXXXXXXXXXXXXXXXXXXXXXXXXXXXXXXXXXXXXXXXXXXXXXXXXXXXXXXXXXXXXXXXXXXXXXXXXXXXXXXXXXXXXXXXXXXXXXXXXXXXXXXXXXXXXXXXXXXXXXXXXXXXXXXXXXXXXXXXXXXXXXXXXXXXXXXXXXXXXXXfXX
