EBo?-o?-MoM-ooMBBB?--M-?-o---M--ME-B-?---?oEM---MMo?B-o---o--B--o??-oM----M-?M--o---M-M-----?M-M----EE?o----BBBMBo-M??o--MEBBBB-B-o-E?---M-M-----oM---oEoME---oM-BMoo-?---??-o--o---E-B---?--o-?BE?M--oo
?MB--M---BME?---M-BoB-B?M?B-Mo-B--E-?ooEoBM-Moo---?----B-MB--o--B?o--E---o----M-----BoM-E?--o---?M-M-----M--M--oB-------?-??oBB-E--o---B-oo-oBM-M----?-M-B?B-o--?-EB-MM-?B-MB-M--BoBB---M-o?o--E----M-oo
Mo-?B-o?---?M-ooE-?---M------o-----?-?-?---???o-oE--o-?o-E?-?--MM-----oE-MB--E---E-o-EE???M?B-B?-oMoM----M-oM----B-B--oo---M-MM-BMMo-M--------M--B--?--o-?---BBooBM?o-----?o--ME-oM-oMM---B?MoB--oBB--oo
B?--MMB-Mo?--M-oMo----M-M-----E-M-BB--oE--o-MoBME-o?EM-E-M--MB-------?BB--?-B-BBo??o?BMoB--?----MMM-M?M-?E-?----oo--E----o----E?BM?--M--?o---o-?--EooE-E--o----MB-o-B-?BMB-ooB-?MB?M-o-?-B--MB-E-M-E--oo
?-oo-M?E-------B-BMM-M-EB-----?--o-----MBBM-MEMM??-E?ooM---o-EEMB-?M-EMo--B-?-B--?-o-B-M?--------?M-------?-?E--?-?MMEEo-?o-B-?-?oB?-B--Bo---MBE----oM-M---E?-?o--o--oE-EM-o--B-?oBo---?M--MEo-MB--?E-oo
-?-M--?-----EoM-E---BB??B---E-MEoBo---M---o--BBEo-?M-----M--E--B-MB-o?--MM--?--oo-----Mo-B--M-EMoo--o---B-E-?MBo-B-B--BE--?-BBM-M-oo?-M--?Mo--M-o-B-o---o?-B?--oo?E-o-?M?ooM-oMB-E--BoM?-Mo--M-?---oB-oo
-?o--M-?-B---B-M?MoB-Eo??B--MM-----E------ME-MM??M?--?oMo--MMM----?o-?E-?----o??BBBM?E---o-?oB--EMM--oo---?---?-B--M??-----o-oB-o-B-M?-EE-o-o-?-o--oB---M--?-Eo???BE--?--M?-?---B-o--o----oo--?---M-?-oo
Mo--??-o-----M-o----??-----oMM--o--M-oE?-E----o----?oM?--E--BB-M--ME------?---M--EE?M?EB-B--------MB--o-?--M-o-M----o--o?-?--MB????--BMMBo-------o-MM--o?-B-o---BoM?--EMM---E--ooM-M---M---Mo--------voo
-?---MM?------oEo-----M----?-B---EB--MB--?--?oB------?--E?-EMBEM-o-?---B--B-o--BMB--M-----MoM--?--Mo-B-M---M?-o----o-?M-B-Bo?B--EB?-?BoMB---M-o?--o-MB---o?---?--MoE---M--B-M-oB-EE?E-M-?-E---------?foo
?o--Bo?-?---E?--M?--Mo--??---?B--B--------E--E-M-----BM--BE--M-B-?--?B--M--MB-B---o-Bo-M----B--?o----------oE?o--?----E---B--?-MBo?B-BM-??-oEoB-B--?-oo--o-o-?-oM-?ME----o?o--BEEM-M-o-----M-B-M--oB-foo
-E?M---EMoE---o-??-oM?---?--o-oB-?-o--M--BM?-Bo-o-M---?-o---oE---BB--B-Bo---MB--M--ooo-?B-M--M-BBBE-M?-B--M??-B-M-B-?E?MoME-E--B?-MM-?E-?--BB-?--BoM?o-M?---??M---o-?--B----B--B-E--M-----BEMB?------foo
-?BMMBoBMMB---EE-----?-o-B-Mooo-?E-------M-M--M----M-M-oM--BBME-ooMM-MB-M--E?---Bo--M-BMBMoMM--EE-?--oo?oo---BB-?-B--MM-?--o-BoB----?B--M-BME?--oM-B-?-ooEB-B-BE------?-?---MB-M---E-?---M??----EoB--foo
-?--o-B?--E-o--BMM---MoE--ooBE-?B----???-MT--?----?--ooEE?---o-?E-oEM---o?--oM?--o?E-o?-o??-M----o?oo--MB?-?o?M-Mo---M------o??--B-M-----oMMMM-o-?----MBM---B--M?-M---o-?E--MBMBB---?Bo-M----M------?foo
-ToBo--B---M---ET-To-oE--T?B?---TT----Bo-M|-M-o--T?-T--M---B-oM-?--T-?TE??M----MT-o-?T-M-BTB?B-M?MTM--T----M--MBBEToo-T--BM--Mo?B--M-T-TM-ET-BM--Mo-o?MMT-oB----o-TM---EEBM-M--?--BEM?-B?M-----o-T-?Bfoo
m|?o--Mo-MMoo-M?|-|-E--?-|---EEo||BE-E-BB-|MBB--E|-?|-EB--oBBME?E??|?-|--EM--EoE|Bo--|E--o|---M?Bo|BEM|-----E?-o-M|--o|EMM-?oBE---ME-|-|--?|--B--EM-EE-B|-oE--?-B-|--E----oM-EB----?E?Eo-M--BB?ME|M?ofoo
XXXXXXXXXXXXXXXXXXXXXXXXXXXXXXXXXXXXXXXXXXXXXXXXXXXXXXXXXXXXXXXXXXXXXXXXXXXXXXXXXXXXXXXXXXXXXXXXXXXXXXXXXXXXXXXXXXXXXXXXXXXXXXXXXXXXXXXXXXXXXXXXXXXXXXXXXXXXXXXXXXXXXXXXXXXXXXXXXXXXXXXXXXXXXXXXXXXXXfXX
