B?-?o-E-o---Mo?--B-?---M-oM--Bo-o?EB-----BM--?oM-------B-E---?o-EM--M-BB----------B-EM?-?--M----oM-BM-B?-o--oB--oBBM--oB-o-?-B---E-?-----BM--B--EoEo-Mo-o--MEM-M-B-B--B-B-B-M?M-M-oo--M----B??-?E--?--oo
?MB--BM----?M--EMEBBMBM-M----E-BM-Mo--E--?EM-BM?-EM-EooM--Eo---------B--E-o----oB-B-----EoE--MBo-??----?----Bo-----B-o---?--B-M---?-o-MEM-M-B---M-------o--EB--o-??-B--M-E?E-EBE-BMEBoM-?--o-?---B-?--oo
?-?-o?-B?o-M---?-?MMM-?o--BB-BMoB--o--?-Bo---B--M?ME-Bo--o-EEMB?-E--E---B---B-MMB-B--B-o-BB-?B--??M-Bo-M------Eo-----oM--?-M--o?Mooo-----?--oM---Mo-B--?B----?-M-M-E--B-M--??--M?--?oB--?o?-o-?E-B----oo
E-B--B-M-E-B-oB?EMEMMB--?-----M---?-M----B-M----??MMMB--E---BM?--Bo--o-E-BM--o?oEM--Mo--o-oB-o---o--?B---MME--B-o------oE?---?M---oB-B--?M--?o--?-?-o-?-M-----B--o-Bo-----?oB-?oB?-B??M-------?--MM-B-oo
----?-B--M--M-EBB-???BE-?--E?-o-?-----o--?-B-BB-o--?EBE--B?---E-oMBB-o---?MM-B-o?B--?-Mo-M-------B--B-oo-Bo---oM-B--o--o?BBE---ooM--B------?---EMoB-??E-MM----E-BB----M-MoMM--------E-BE---E?--o?oB??-oo
--MEM---o----o--oMo-B-B-o-oM--MM-???E--M-?MMBB-M--oBB--?MM----?-o-MM--?-o?---?--?-?Mo?B?-o--?-?-B---E--B--?MM---EB-------B--M??-?-oBM-o-?M?M-E--M--oBMBB?B-Mo--M-M-?o---o---B--M--o-MEM-oM?BB-Bo---?--oo
o-BB-o?BEo--o-M---M?E-E-?--M-?BMBBBM-B-??--E----MM-Bo--o---M----o-o-M??-oM?-o---MoMM-----B---?--M?oE?----?o-MB-o--E?-?M?E--M?o-M--?-BM--B-M--B-oMo?--MBBBEoM-M-o--B---?--?B-MMM-E-M--B-?MB-E-Eo-B-?Mo-oo
Moooo--M?---MM---MB-?-Mo--M?-o?M-?----BE-B-------o?B-MBB-BBB--?o------o-oE---ME-E--?-oM--ME---?o--BBo-M---EMoEE-M-?---E--Eo?--E--E-B--------B--M??---------E--oM-?o-ooMMo?--oB--M--oM-?oo-BBo---MEB-Bvoo
-M?-----o-?B--B-??--?-BM---o-Eoo?-B??EB?B---?------MB-B-MMMo-B-MBEBM-E----BoM-MBM-EooBM--o--o-----?----E--B--M?E-----B--EB?--?B??B---o---Mo-BBM----E-o-o??-Bo--??o-BMoMoM-M--Mo-?B-E---?-oM-?--E--o-Mfoo
----??o--E-?--M-BBM-B-----B--MoEEo-M-M----EoEM-BooB-------M?oB-B-?BM--oE-?E-?-EMo-Mo-oB-----B?--E-------E--oB-B?-?---E--BBooM--B-M?BMoB--o?---Bo-oEM--M-----oM-Mo--o--M--o-Eo?-MM?o??-EM-o-----BoB?o-foo
o-B------?M----o--B?-EE?--?B?E-BBo--M-BEo--MMB-M--?o-BMo--M-o?-??-BM--?M--MM--Mo--o-??-B?---EB-M?---E-??--oMo---MMB-BB?o---?M---EE?E?Mo-oBBM?-??o-?----o------o???Bo-M--E--??MM--M-EM?Mo--?E-o-M--MM-foo
o?---?oo--?o-B--??M-E-?--B-B-ME-M--o--BMBB-MMEo-oo-?--o---?MME-B---?--Mo--E?MoE--E--oB-BBoB-BB-o?MM--??EM--M-MBME?---B-?-?-BM-?B?--?-ooo-MMMM?-E---M--E-?---?-M-o---?--?--E-oBE---BBM--o----?o-BBEB-Efoo
oo---M-MB-??-M-M?o------?EE--M-MBM-o-o-EB--?---E?-oE-Mo--?-o?M----o-E?--Mo---E----E-oE-oMM-oM-M-M?--EM-MB?M-oM-E------?-----EBTMo-B-oM?--M-EMMMB---EMo?-M--M-E-oooo?--?-M--MBM--o-Mo?Mo-o----BBoMBEo-foo
---B-BBT?--??M--?-o--?T-oBB---B-oM-?MBTTo-?BT--MT-?-T--?--B?--??ET?-B---o-?--TT-?MT-BM--ToB---?-BM-?TE-E--T?-M-TBEMMBBo----M?-|-ooE--BT----?B--E--BM--B-BMT-T-o-ET?-o-B-M--M-MBMM?---B?-TEE-E-o?Bo--Tfoo
m--oo--|?MBE??EB-o-?Bo|o-E--BoB--oBMM-||o--M|o-?|-EM|oEE---E---B-|oM-o?-EBM-?||B-E|-BBB-|o-BEM----BM|BB-oE|E??-|MMEEMME----oM-|-M?--?M|?---?---?---MM-oEoE|?|-?B-|-ME-?BoME-E-E-E??--oEM|?M--o---oBM|foo
XXXXXXXXXXXXXXXXXXXXXXXXXXXXXXXXXXXXXXXXXXXXXXXXXXXXXXXXXXXXXXXXXXXXXXXXXXXXXXXXXXXXXXXXXXXXXXXXXXXXXXXXXXXXXXXXXXXXXXXXXXXXXXXXXXXXXXXXXXXXXXXXXXXXXXXXXXXXXXXXXXXXXXXXXXXXXXXXXXXXXXXXXXXXXXXXXXXXXfXX
