E-EM?o-MB-M----o-?-o--oBooM-o-B--oEoB-o-o-oE-B---Eo--M--BBB--?-o----?M?oEB?-?-?-BBE--B?---B?-o-?M--MEMBo-?M-BB?BM---Bo?B-o-E-MMEM-Mooo---B-o?BM-o---o??---M-?BoMBoE-E-B--MMEB?--BB-M--E?B-??BBo----o--oo
M--E---Mo-?BE--Mo??---E??B--ME-B?-?-oM?M-M-?oo-E--E?--B-oMo?o-------o--MB?E??---EE-E?---Mo?E---M-o?E???o?M----M??-B-B-oMMEB?BBo-ooB--?MB---M--MBMM-------M-o--o--MM-BM?Eo-B--BB--E--?o-M-oooBME?M-o-o-oo
B--?B--?----M?-oM?o--??-??------?M?M-Mo-M-BE?-?--MBBo-o??MoMMEM---MMMBM-MMB-B--?M---B-?--M-M-M--oM?BB---MBo--M--M-----??o?-?o?-----ooM--???ME--ME-MoEMo-M??o-oEM-------?-BBM-B-E-Moo-------M?oM?-oBMB-oo
BM--B-B-?-B--oE--B?o----EEo??-M?B-M-?-B--o--E-?---M--oB----o?B-o-Mo-o--Bo?----o-E?E-MB?o-Boo-EEM?-M-o?o?-----oM--?Eo?o-----BBo-M----B-o?-B-?--M--M?---?-M?---?MM-E-----BMEoMooB?MBM--M-?-oo?-----EM-o-oo
M-?-?BMo--o-o----MMoE-?oM??-----o-M-------?-------?--E-BoM-?o-oo-oM-o-o-B??EM--E?-B?o-?E--BM-M??EB-?--oB?o-?--MEo?oE---Mo-???---M---M-Mo?o-Bo-B?B-B-o--M--oB-??--?M?M??--?-M?-M?BB--o-?M?-?-?E?oo--?--oo
Bo--??--M-MM--?BE-B--BMB?-Mo?-?-Eo?Mo?--o-BBMoMEE-B-o--ooEM-M--E-?----?M-?M--o??-B-M-BE?-MM-o-B---M-B-MBo-B---M--Bo--?--MM--oEB-B---?--BM--oM-?M--??o---??B---BM--BBE--M-Mo?-ooo---o-M-?-Mo-o--o-MB---oo
oo?-?o-?M-E--M-oM-?ooB-oE-B---oo-E--E--?Bo--M-M-M-M?------o-M------o----???EoMBM--oooB-B---M---?--?-oB-BE-oMEEBM?-o?-??M-MEoB-o-oMoBo-?--B-B?---oB--MBo--oBE-ME---M-M-o-???-M-Boo-o-B?-?---?-o-o-B-oE-oo
-B?E-B-Bo---MB-B--E--o--Mo?E-B-?EM-EME----o-M?B-Bo-B-?M----?--BoBME-o-Eo?-E?E-o-oMooMMoBMB-MBE?BB-?-B--o?--B-MoooE?E--o----?-B--o--??-o?-M?oooMEM?-E-E-Eo?-??-?-E-oB-oMMBo?oM?BooBB-EEM?MM-EE-MB?---Mvoo
-B---MM-o?M--E-Bo-B-?ooEMM--o-Bo-----M-o-E-?M--B-o-----M-o--Mo-B-o-Mo----?B--?-o?oM--B--o?o-MM?oMoEBBMM-B-B---M--?-?B--M-?E----BoEo?o?--o-B??-EB---M--MBMo-Bo--o--oM-?-MMBM?B-Mo?-o-?M--M?-M?oBMBMoBMfoo
-MB?--B-B-----M-B?---oEM-Mo??MBMMMB---Bo?-?-o--o-o-oo?o----E?---o-oo??o---oE-?B-o-B?B--M?--Mo-oM?MBBE-E?Eo?-Eo---M-M-E--o?B-?-oB---BBB----?-B-M-M-----B---o----EM-?--BMEB--?M-MBB?B?o-oE-?-o-----o---foo
---M-M-E-MEMBo-B-?-EE-?--?----BMoo-o----o?E-oo?M?Bo-Bo-MoM-B------B--oM-??oB--B-EM---o--M?o-MB-oBB--?M-B-BM-?E-BM?EMM?ooM-o?-?EB-ooME-oM-o---E--?o-?---EM-oo--EMB---?---BEMBBoEE?-BBBM--M-EoEoE?-BoE-foo
o-??-MB-BoMo------oBM-E-o?-?E-Mo-----oEoEoME----?M-oo-oM?-MB--E---Eoo--?---o---?B-o--?--o-o--EME--?----EBBE-----B-?--?-?E-EM--oMMM-?B?-B-?-B------oBoMB--B-Bo-----Mo----EB-?MMB-B-?MBo-o-M-E-?BBo---?foo
Bo-o--oB?MM-E?----o-?BMB?---?-??--EM-BB---E-M-oo?-oM---oo-oE-BM--M-MMo--o-Bo-M-?--B?-o--M?ME-?--ooBoo--B--?M-M?-??-MB-MoM-Bo-E?---?oBMB?----?-BMM-?MM-----BE---B--EMMBo---EoM--o--?-B-o-o--??oBMooB--foo
---MTo-B-?-----?-oM?-MBB--MoBMBBE-?------T?--E-o--?-?Mo-T-B--BTT--MB-BTo?M?--oT-oBTM-EM?-o?M?--MM---?o-?-E?o---oM-o?ooTE?-BoEBTT--oM?oBoTo?BB-o?---M-?M--o-To---o?M-oT----?--M?ET-?o?----To--B--?-M?-foo
mBB-|-o-E-M-BMMBEoB--oo-M-?MBEo?B-EEBoo?-|B?--?B-EEBoM-B|ooo-M||-?o---|oo?oE-?|-?B|---oEE-oE?EMo?oo--BMBEBoo-E-M-oo---|----Boo||-?EM?MoB|?o-E?MM-oEM--M?--B|EM-?-BBEM|oBM--?-EM?|oo-EMo-E|?M?E----B--foo
XXXXXXXXXXXXXXXXXXXXXXXXXXXXXXXXXXXXXXXXXXXXXXXXXXXXXXXXXXXXXXXXXXXXXXXXXXXXXXXXXXXXXXXXXXXXXXXXXXXXXXXXXXXXXXXXXXXXXXX----XXXXXXXXXXXXXXXXXXXXXXXXXXXXXXXXXXXXXXXXXXXXXXXXXXXXXXXXXXXXXXXXXXX----XXXfXX
