----?---B--o--M?-B---?B-B???--B-o-M-MM----o-B-?E-BoB--M-B???M-oo?-o--M--?B-B?-?-------MM?o---Eoo-B-?B-BB---BMMM-oo?-oooo--M-E-BM-B----M-B-Bo--M-??-?o-B-----B----Bo-?-?----M-B--B-oo--M-?ME--ME-B--M--oo
B?M-B--??BoE-o--E-?EE---EMB-?-MB-----E-----o-EB-?-?---E---o--?ME-oBB?BB--oEo----o-BB--oo---o--BBo--??-----EMoB-M-BM---M--E-o--M--M?BB?---o?-B--BMBBMBE-oBBBM--MM---o?Boo?-?M-M?---MB?--E-BB--MB-?o----oo
MM---o-?----?-oBME-MB---BMBE---M?-----?---??-Moo-M-E-B?---M??MBMo??o-oE-o--o--B---B?ME--o----o---MoM-B?B---E----oo???o---B-o-o-----oE-E----E?--?-EM?--M------EM-M?-M---?M-o-MMo-E----o----MoM----B-BE-oo
??B-E?-----?-M-BMBo--B-MMoo---BBo-M-------MM---E-MB--o-M-E-BE-Eo?-----B-E--ME-EM--E?MB?-oMo-?-o--MBBB----MMM-??-M-Mo-E-EE-----?--M?-??--EEM?oo?-B-M-MB-M---E-?BM--Boo---?M-Bo?---E--o?o?E---?---?--o--oo
-o-o-o--EMB-MEE?-BBM-Mo???oEM-o--?-o-EM-Bo-oME-?-M?MoE----MMMMB-oMoo--o-?-E-MM??---B-B--o?E--M--oEoM-o-E?-Mo--M--EBE-B-MB?--oBM-----o---M?------E-oo?-B-M-?--?----oBoE?--B?ooM--??EM--B?MB--Bo----Mo--oo
E-?--B-o--BM-M----o??B??--o-o?--M?B-MB-MBEE-M?M---o-----BEMoMMEo--o?---?--B--M--B-BM-o--?o-oMoo?o--EBooBMB-M---oo-B?MBMEo-----oo---MM----E--EM-??-?oM-o-B-oB-E--?---B?o-M?M-o--?--BBo---B-----?EB-----oo
MM-----M-?Eo--???---M---BE---ME--?-BB?---?BB-o-oBoo-o---o-B-BE?-EoMB-MB?--oM-----B-M-?--BoM---ooB-o----EE-E----M-?B?--BMo-E--M-BEBEB----oB-oM----M?-?---oEMo-MBB-?E----o-B?--B---oBE----B---oBBBM-----oo
E--BE-----?-----ME--BB--?--?-?------BM---M----?B--?-----?oEE-?o?---B-oo?-o--E-Eo-MM-MMB------B?-EMM---B--o-Mo-o-M?B------EMo---BM---EoM-oo--?-?-M-?-M----M?---?--M-o--?B??B-?M-?oB-?-ME----?MBE-o-Mo-voo
---EM------B-?E-??EM-o-o--Mo---B-------oBM-oM-B---o-oMo-?-MMo-B-oM-M?--EB-Mo?MMo-B-M---o--M?B-B?BBB----oB--o-M?--BM-M--E-----M-oM?--BB?-oM-?--Mo-oEMM--oo----BM-----M---?MM??-B-o--oB?B?--o?-B?---??Mfoo
---B-Mo-Mo--Bo?BM--MEoBB--B--E-B-M--MM-----BM-?-M-o?--o-----B-----E?E-E-M-EE--oBo?o-ooM-B-o-?--E??--MEMo-BBB--?M-?oM-E-M?E?E-oB---BM-MMBEB--BoM--??M--E-?-----?-o-B--o-M-----MBB------B-o-?-EEEM?MB--foo
oEMo?-?--M------o----M-MM-?BoB-o?o-M?---MB?---B------BM--B-M-BMB-??EM-?-EMB-?E--E---Mo-M----B-oM-oM-----B?------oBMo-MEBM??M----MBBE--MM-B-oBMo?oB-MEB-oE--o-M??-??oo?EBM-------o-?o?-MEE-?-M??-oo-M-foo
o--B----oM?M-B?-oMo----?-o-E-M--M---BB---MBMM?M-E--B-?-M-??---E-Boo?E-B-???B-?-?Mo--Mo-oMo??-Bo-?--MMM--MMBB-?-o?oBBoo-------?o?BB-BE-B--ME--MBB?B-oBBo?B?o---?--oBooB--?E-MB-E--?-B------o---M?o--E-foo
----?--o-oBME----oT----B?o-MB-Bo-?B?-------?-B-o--?oEoE-B?-?-MM-B?--?ME-o-----M?--Bo---MM------EME?Mo--?-B-M-M?-T-??-M-E-?---BM?BB-M?BoM??B------E-M?-MMMoBBM?E--?o-BM-E-BB-------oBoo-T-o--o-o-?-?--foo
o?T?-E-oBEEo-BoBo-|ET-TT?-M--??-T-Boo------BM?M-E-TMBE?-?--BTTE--MBo?-MMBT-Mo-MT----E-EB-To--??B?TM--MMTB?BB-B--|-???BB-oT-?----M-E?-oMT-BMo-o-M-TE?--o-----o-M---T---oBoBE----o?ETE?o?|B-MB--BTM-B--foo
m-|-oM?o?-B--MM?-B|B|-||-M-?EBMM|E?M--M-?-EEoB-?-B|---BEE-E-||-Eo-M-M-o--|-BE-?|-?E-M-?o?|oMB-E-B|?MB?-|M-B-EMBB|MBEBo?--|EBoB?-?--E-BM|o?--B?-B-|-?-E-E?-M?----?B|--B-M--MEBEoMB-|?-B-|?MBM--o|-B-o-foo
XXXXXXXXXXXXXXXXXXXXXXXXXXXXXXXXXXXXXXXXXXXXXXXXXXXXXXXXXXXXXXXXXXXXXXXXXXXXXXXXXXXXXXXXXXXXXXXXXXXXXXXXXXXXXXXXXXXXXXXXXXXXXXXXXXXXXXXXXXXXXXXXXXXXXXXXXXXXXXXXXXXXXXXXXXXXXXXXXXXXXXXXXXXXXXXXXXXXXfXX
