MB-ooMo-oMBoB-B--o-B--?-E-M?oM?-M-M---?-MoBoM-MMoM-M-B---?-B--oB--M-Mo----M--MBo-o---B?BM--B-------E-?M---Bo-MBM--o-?-?oB-MB--BE?----B-BE?--oMB---?-B--EM??-----?E----Eo-BEM--MMM--o--MB-E-EM-MM-?B-E-oo
-M-o----o-Bo--E-EoBEo-o--?----M-B?---MM-o-?-M?-M-o-M----B-----M---------E-----EM-B?-o-B-o---M--E-E?----MB??Bo---E-M-?EoEE-o--?oMoEMM-B-M-MBM-o??oo--Eo?--B-oB-o?-?EE--?EM--Booo-----B-BBMB--?M-M---MM-oo
-Mo?oB-M--B-?-ME?-MB-M-----EBoB-??oB-B--E?-MBoBBE-BoEM--o-oooBMo-?MEMM--Mo?-M-MM-M--EoMMM--B?-----BM-o---Bo--oMBM-M-oM--?--o?B-?--E----?BM-E?-M?--o-?--------??---BB---MEo-MBM-----?----B-?oBBBoo--?--oo
B-ooo-B??--E--M?M---MMB?EM?---?MM---?B?-----B-MBB?--MBB-?-E?B-B--o--?---ME-o?B-B-oM-MBB?Eo-BB?-?-ME-oBBM--B-E?B---EBo-EME--B-----?-o-o----M-----EEBMEBMB-o--BE?BM--MMMB-?--EB--MBBBo-Bo-?oB-Mo--BMB-?-oo
Mo?E-EBoo-???B----B-----?----Bo?--ooo---?---B?--E-oBB-MB--?MB-----B--?E?---M-o-o--o-?-MMM--??---MMM----?M---??-MB-M-B?-?-?B?-M--M--oB?--M--?---o-B----oEoMo--B---o-B-EM-?o-B?B-E------?--MB-?EM?o-?oB-oo
---?M-?----BoEo-----o--?----B-M--E-?M?Mo-oE-o--B-----BM-?BMo?BMoM-oooEB-B------?---?--M-?-M-E-Bo---?M---Mo--M-?--M?E----o-MMoo-?--?-----M??--E--EB-----MM--E-?-o---Mo--oo-M-M?-B-o-EE-o--o-o-M-?BoM-o-oo
--MM--oB?--B---Eo--??-??-EoMoB--EM-B---M-MM--E--B-oEo------BooBo---?oMM??-M--B-M---?B?E--o--BBE?EM?----oo-o-M-E--oMB-MM-EM?o-------o?--B-M--o---M-?-E??M-oEBoBoM--------B---?--B?o-BB-o?---??-E-??----oo
---oB-ooMBB??-M--o---M-B-M--?EMMBo---ME?--ooo--M-o?-B---o---EoMB-M-?--?o-oB-o------E--M--?-B-o---?--?-----B------oMMM-?-BoEBoM-M-o-?----o--oB-B?-Mo-?M--M?B--oB?--Eo----oM?oMM-?---E-M-MB---?-?E?B?-Evoo
-----M--BBo?--BM?EE--M--?--???--M-BB--BM--B--M-B-----Bo-B-?M-B---?------B?Eo?BM?MoMMEo-?M--?---E-----?--oMBE-?M--M--Bo-B----oM??----M-oB?oM--B---B-?--BoMMEo---o-----oM---??MoB?------ooBE?-M?oBB-MEBfoo
---E-----EM?----MB-o-E-o---?--MEM-EoE-----?oM?M-----M----BMM-----B-BM----B--ME-Eo?---o-MB-BB----oBMBMo--?B-BMo--o?--?o----o--o--M-EB--M-?-o?-oM--MB-----?M?---??M---oE---M-?--E---M---?oB---?Bo?E-B?Efoo
---BoE-M--?--?B--o--?--o-?-MB-----B---o----MM-oo--BoM?--B--?--??-B----oB--??-B-B--oEo?E??o-MBM---o-M-o-B--M--BB-Bo-o-B-------o-M--BB?-?-oE--M---?M-o-o--o-B--o-?--B---o---o?o??--?-o?B?---?ooM-B---o-foo
-Eo-BM-B-o---MMB-?Boo-M-B---M-M------E?-?MM---ooMo---M?-----o?BB--B-B---?--M-o--BE---o--?-M-?BB---E?-oo---o--?Mo--E-o-ooEM------?---MM-EB-oMo-B-oo---M-M-M---o-oBMM-M-Mo--BM---BM--o-oMo?-?o--M?BE-?ofoo
-?oMB?-E-oM-o--?--o-----B---M--EM?---B--E-B---M-M-Bo--MoBEooBo--BT----EB-oM-?-M-M?-oB-MBo----??--oB----?oEM-E---B--?-MB-B-ME---Mo--MoMM-----MB-B--B?---?-Mo-B--?E--?-oBBM-B-ooB---o-M--B-o--T?---B-MTfoo
--BM?B-?-o-B-o--T-?B?B-o-MM--T?BB-ETBE-oT-T-To-o------M--M--?T-TB|---?-oBT---?B?TBB--T-EBT---MB--TE--EB--T-ET?o-?--?MT?-?--?MEB-E?M-oooo-o----MEo--o-T-M?-MM-M-??-oT-T-oo--BTo---Mo--?E--BM-|M?MBMMB|foo
mBEMM??E-EB-B-B?|oM-B-EM?-EM-|??Bo-|--?B|E|?|B-B--Eo-EMoBoB-?|B|-|o--E--?|Mo-E-?|o-M-|--B|EEB-oBM|Bo-?-M?|o?|o-o?-B--|MM--BM?-?---o-?-?-oBoE?oMBB--BM|-o-B-M-E-B---|-|B-BM-o|E-----o?BBE-?o-|BE-?ME-|foo
XXXXXXXXXXXXXXXXXXXXXXXXXXXXXXXXXXXXXXXXXXXXXXXXXXXXXXXXXXXXXXXXXXXXXXXXXXXXXXXXXXXXXXXXXXXXXXXXXXXXXXXXXXXXXXXXXXXXXXXXXXXXXXXXXXXXXXXXXXXXXXXXXXXXXXXXXXXXXXXXXXXXXXXXXXXXXXXXXXXXXXXXXXXXXXXXXXXXXfXX
