----BM-?---o---M?M--MoBoB-oEoB--oE-BEB-E---?E?B---oB--B-MBoMBM---B??E-??--BMo-?--M-BB-?M-B-Eo-----BB?MoB-MB--o-oM--M-B-E?-?MMBo????-ooo-E--?-o-E-M-B---B-BEM--B?-Bo-BB---o-BBBBM--E-B--o----B--M?---?-oo
o---B-----?MoB?B?--?-ooB-E?M-Eoo------o?-o-?B--?o-?MBME-?E-?-M-----B-o?B--o--??o----?oo-------BE---Mo---B-?-?E?--M--?--B--?E-?-oM-BMME-??M--o?E--E--?o-------?M---BBB-B?M----E-?BBBEBE-M?EEM-----oB-o-oo
--o--o-ME?Eo---M-?--Mo---?o--M?MooEB--ooo?---o--MM-M--MMo-----B-M---B-o---o-M--o--o?M-E--M-----B-o-?--B?--o-----MBBo-EBB-M-B-E--Eo?-B---B--B-M-o-?oE----M----B-B?----BB?-oB--?o-?-??-?-Mo-M--E--BB--o-oo
E-B-oEM?M?Moo--o--M--B-B-EoB---MM--B--oMBMo-M-E------o?MM--??-?-B-M--o---Bo---BB?E-oM-B---o-?M?-M------B-oooo---B---?---B--o------ooo--o--ooE----??B?M--M-M--o-B-B?----B-M?oEM?--o-o---EMBMEB-o-B?oM--oo
------Eo--M--oo?M?-?--ME?--?B-?-BoB-oBB-?-M---M?-o-----M-MoB--E-?-BMB-?oE?-?-?MMoMMoo------o--MBBoBo--?--?B----?ooM-?-B-----o----E-MBo-M-Bo-MB---?--EMB-----M-----oo---EBBMB?M--o-M--M-M?MBM-E?---B---oo
?oMo-M---?-oB---M-B--?M----B?M??-?------BMBo---B-?--?BBE--MM--M-?-M?-B-EM-M??oo--BMM---BM?---BM??-M?-?BM-B--EBE-M--oM-Mo--Eoo??-MBE-M?EoBMB--???----B--MM-o-Bo-oM?BB--o-?-??o--oMoB--?B-o-MM-oo---?EE-oo
o-??E-?-MM-Mo-BEBoo--?B--o?o---o-M--o?-?Eoo??-?---M-B??B?-oB-o-Eo-----E-EBoM-oo-B---oMoBE?-??B-----oooE----EB?M-MEBo-M-MoB--?BB---B----EMBBoo-E??E-M--MEEM?MM----ooBB-----EB-?Mo--?-?BM-B-?---B-?-----oo
-o-?Bo--o-M----Bo?M??--EE-MoE?-oE-oM--B------BoB---M--o---EE?B-MBM------BM?MB-oo-----o--MM?-oEo-BBEMoE------B---B--?--?-M?--?---B--EB--?-??-B-B--BMB---MM--B-?---o-?M---M-B-Eoo---EE-oo-M-??oE---E-M-voo
o-B--B?-----?o--Bo--B?oBM--???-oMM----BMBo-?Bo?E-oBM-M-ooo---??-oE?EB-??-?B--o??---?--B?Mo---?-----?-?----o---Eo-?-M?--B-M-?--MBM-M-?MM--M-----o---BooEEE-------M-?-oME--B--B?--?B-?o-?--EMo-?-o-?-B-foo
o--BB-BM--B?B-M-?-EB-M-Mo-oooM-o?----o?-BBo---o-B----o----MoB--?-?o-M-EMo?B---M------oE-----?-EMo?M--B----o-M-BMM------EoMMoMBB-M--oM?MoE-?BE-B----oBM?-M-?E--o-o--M---?BBoB-----BE--EE?----EB-BE-M?Mfoo
---M?oB---EM--?-?--BM---oM--B?MM-?-M-M?B--??-M?--?oB-Mo-o-o----MB-o-B--o--E-?-EoE--MM-MM-Mo-?-B-oMo--M-oo----o-?-M?BE-o---?Mo?-B----oMo--B-E?-o-M-M----o-BE-B-o-oB-M?-MM-?oMoBM?--?--??B-oo-?--?---?-foo
??-MB--M--Mo----BMB--E-?M---EE-?o-M?B?--?E--?oMo--?-?--BMEMBB-E-M??BB-oM--?M-BBoB?B--B-E?-B-?--M--?--oo-------o-----?--EE----B------o-B-oB?---o--?-EEo-?-?-EBo--M-M-?-o-M-T------oo-M--BM-E?o?-?o--o?foo
ooBo?ooEMM?E--E--Eo--B--B---BM?--o--M-o-M--BM----B-ME?---?B--EMo-E-T-M?--E--?--M--?T-?o-TBo-B-E--E-o-EE--?---?E?oo----?BM--EEo-M---o?B?-B?-o-?EE----M?---?-?o---BoBM---MB-|--MMBB-MMM-?---B--o?---?--foo
---BoT--oE?TMMM--M-T-o??E-M-Eo?TTT?-T-EB-M-M?---Moo-T?TBEB??B---oMo|M--M-?--o---o-M|-??o|T??---oB-M--B?M--o?BE?---M-ooBMB---?---MMET--?-oTT?--T-oT-B-M-ME-MBMT?M-ToT-E?-Mo|?B---B---T-o-??B?TM-------foo
mB---|oM--o|M???oMM|-MBo?ME-B??|||MB|M??o-BE--oMoBE-|-|E-B?-?-EBBEE|Eo-----BB--E?--|?--M||-oEo--E----?EB--?-BBBM-M-E?-MEEB--oE--M-B|-M-E-||-BM|--|-B?--?--oE?|E-o|-|-?MMB?|o-B--EM-E|oo-E-MB|oo-?-?-ofoo
X----------------------------------------------------------------------------------------------------------------------------------------------------------------------------------------------------fXX
