---B---o?--E-?-o?E-E--o?o--?-B??---?MooB---M--ooB-oM--oEo?---o---B?EBo?MM-o-o------?--M-ooB---oEEM?-o-M-M-Bo-Mo---EBBBo?-o-?-BEoMo?oM---M--?E---?BM--BB-BBE-E-?B---?oE---M-M---?MB---M?---oE-E--?---M-oo
??-M--BM---B?-ME-MEBM--?o-o?--oM-EE?-E--MB-oo--?-MoooBo?---Mo?-o-?-BME-o-o?oM?o?---?--BMBBM----M-M---o-o?M-B--?B?---o-MBoE--MMM-oM--MEo--M---M?-BM-o-o?B-MMM--?Eo-?---?---E-?B?-----M------MBB-o?--E--oo
BoMM---B--M---M---M-B-----?--oB?M----B---o---??-E-BM?E?-?-?ooBo-BM-?--------?--E-Eo--o?--M?M?B---B---BM--EooE-B?-?M---?-??--B-Boo-Eo-MEM---o--EooBo-----MBMo?----oMo--o-----BoM---o?o-EB-MMBE-?-M-----oo
-ooo--??oM-o?-M-----MBoB-?-?o---?-----E-?-o-o-oM-oE?E-----oM-M?-oBoM--EB---E-?B?-B---B------BBME--MEoB-ooB-B-Mo----?-BM-M?B-o--?-----MBMMEo-EM?E---oEoBE----B?-oo-MME-o-?Mo-M-BooB--o-o-ooo--E??M-o-?-oo
?-?----MM-MM-o-B?-M-EE--?--?--E-MMM---??--MBMB?B?o--MoooBMM-M-?-BMooM---BEB?--?o?oo--M-MEooBM-B-?--M?-oMoMo-?MMB--MB--oBBMEB-o?-?-M-oMBM--B-Boo--??o?-E--?-o--E--E---o-?-B--ME-M?-o?-o-E-?-ME----o-B--oo
-MBB--o?ME?-oB???M-oBM---?oB-E?E--E?-BE?--MB----B-o-M--?B------MBo?-?M--?----B--M?--E--EMEM-?E--?-----BMEo-oE---o?--o-M---BEB-B?---BB?o--o--Eoo?B-B---MM?-Bo-?BB--EM-EEoMM---MB-o--EB-M--oE-BE-B?-E-o-oo
o-EB-o-?B--B-E-?---Eo-E--BMo--BB---?oo???---?--?-o-??-E-MM--o---o-o-?oM-B-BE?-M??--o??o?E?-o?B---B?o---B?E-?BM-o?E-oE-M-?--B-M-?-MM--B-o---M?oo-E?BoEEoMM-M?o?-BoEMo----?-?BB--M-o--?o--Bo-M?B-Mo-BB--oo
BB-oo--MoB-oBMM--oo--B-E--?oo------B--?-oo------BoMM-?M--Mo-o-EoBoB--oo--M?B?--EMMM?M-BM--BoMB--M-B-?--E-oE--B-?--o-----E--------oB-??M?-M-?E?-M--?-MB??-BM--BM--BoooB-o---M--oM-B-B--M--B---M--?--E-voo
BE---B---?E??o-----?-BB--o-M-o?o---M-B-?Bo--Mooo-oB--MMB--B-M--o---M---oo--M-B-Mo-Mo?--Mo?--B----BM-MBMBBo--?----?-B--B-MM-o??-oEoM-M-o--o?-M-M-MM-E?M---o-E--o-o-E--?-oB-MM--o-M-EoBoM-Mo-B-M-?oM-?ofoo
----M?EEM-B-----B-oBM?B----?B--?o-MoBo--BEo---oM-o?MMB?-o-?----BoMEE-E-Bo--ooEoB--o-B???B-M-------M?--?-B?oo-B-o---EE--oBM--oBMB--B-----oM?-?---o-BMM??o--?B?-------oo-?--oME-?-EEMM-B?--oooE-B--M-M?foo
oMoo--M--??Bo-o---MB-EMBE-?--------E?-?-?BE--?-?oB-E-oM--o-B-oBE?BBM-MEM--?E-M-?Bo-BB-oB---o-o-o--ooooo-M-oo?BMM?--BB?Mo-BB--oB?-BEoMo-oo--oM---ME---Bo-E-oo-B-o---o---MB?-o----?-?B-o-oM-?EB-M?o---Mfoo
--MB-M-??M---?M?---E-?--M?--o---M?-BB--EMB----??--EMo---?----?-?---E-MBM-B-B--o?M--M--EB-o--MoM---?-o-BB?o-??-?-E--B---BEBM---M-o?--M--B-E-EEo??--MEoo?-?-E---M-ooo??o-M-Eo-oM-B-?o?--BE-M-?MBB--M---foo
--M-M-??--?-B-o-oBE?o?-T-o?oE--?-B--?-M-MM-B-BB-?M?oBo?B-B-Eo---o-oB--M?M---MMoMB--B?M?M?MMBo--oB??oo-E--o--MB??BoM-E-oMB----M--oBEB--EBoB-BM--?-E--o---oMMEo--B?EM?MB-To?-?-?-o--BM-M--ooMB-??-o?-?Mfoo
?B?--oBM-o-o--MTTo?B-?-|----??o?-o-B---BMM-MoM-TM?BoT--Bo---B-ME?TT?M-oTTMoM-oB-B----M?--?TMM-??To?MoEB?o---M-EE-M-BT?----E?M?---MoB--TB?oM-ETE---oooo-EB?-M--o--?--?oM|-o-o---?-E-oEEM--T----Eo-?M-Bfoo
mMEE-Bo-??oEB?M||BBB-?o|o-o?EBEME-----E??BM?--?|BoMo|B-MB-?-E?M?-||oE-M||-BEE-o-MB?B-BMo?-|o-?M-|o-oE-BEoo-Eo?BM----|MME--M-??--M-EM-E|oo?---|BoooMME-M-M-o-EEoM-o--E-E|-M-E-E-?EM--B-EEo|--oEB?-----foo
XXXXXXXXXXXXXXXXXXXXXXXXXXXXXXXXXXXXXXXXXXXXXXXXXXXXXXXXXXXXXXXXXXXXXXXXXXXXXXXXXXXXXXXXXXXXXXXXXXXXXXXXXXXXXXXX----XXXXXXXXXXXXXXXXXXXXXXXXXXXXXXXXXXXXXXXXXXXXXXXXXXXXXX-XXXXXXXXXXXXXXXXXXXXXXX---fXX
